a --> ['dark urine', 'itching', 'weight loss', 'yellow skin and eyes', 'fatigue', 'fever', 'loss of appetite']
abdominal aortic aneurysm --> ['nausea', 'pulsating abdominal mass', 'abdomen pain', 'back pain', 'flank pain']
acl injuries --> ['bruising', 'limping', 'pain when standing', 'knee pain']
acne --> ['pimple', 'blackhead', 'pimples', 'redness', 'tenderness']
acquired immuno deficiency syndrome --> ['opportunistic infection', 'headache', 'oral thrush (mouth thrush)', 'pneumonia', 'red blotches', 'severe unintentional weight loss', 'skin rash', 'swollen lymph nodes']
acute cholecystitis --> ['abdominal cramping from gallstones', 'yellow skin and eyes', 'chills', 'fever', 'sweating', 'bloating', 'nausea', 'vomiting']
acute encephalitis syndrome --> ['irritability', 'light sensitivity', 'headache', 'stiff neck', 'reduced sensation of touch', 'seizures', 'nausea', 'vomiting']
acute lymphoblastic leukaemia --> ['bleeding gums', 'easy bruising', 'infection', 'nosebleed', 'pallor', 'red spots on skin', 'shortness of breath', 'swollen lymph nodes', 'weight loss']
acute myeloid leukaemia --> ['bleeding', 'bruising', 'infection', 'pallor', 'red spots on skin', 'shortness of breath', 'fatigue', 'fever', 'loss of appetite']
addison's disease --> ['absence of menstruation', 'craving salty foods', 'darkening of the skin', 'excess urination', 'muscle weakness', 'reduced sex drive', 'weight loss', 'nausea', 'vomiting']
adhd [attention deficit/hyperactivity disorder] --> ['depression', 'learning disability']
afib, af (atrial fibrillation) --> ['shortness of breath', 'dizziness', 'fatigue', 'inability to exercise', 'weakness']
alcohol --> ['physical substance dependence', 'problems with coordination', 'slurred speech', 'tremor', 'blackout', 'dizziness', 'shakiness', 'craving', 'sweating']
allergic rhinitis --> ['coughing', 'fatigue', 'headache', 'itching', 'phlegm', 'throat irritation']
als [amyotrophic lateral sclerosis] --> ['difficulty raising the foot', 'difficulty swallowing', 'drooling', 'lack of restraint', 'mild cognitive impairment', 'severe constipation', 'severe unintentional weight loss', 'shortness of breath']
alzheimer's disease --> ['inability to combine muscle movements', 'jumbled speech', 'loss of appetite']
amblyopia --> ['eye misalignment']
ammonia --> ['coughing', 'fast heart rate']
amoebiasis --> ['weight loss', 'fatigue', 'fever', 'loss of appetite', 'blood in stool', 'diarrhoea', 'flatulence']
anaemia --> ['brittle nails', 'hair loss', 'headache', 'irritability', 'restless legs syndrome', 'shortness of breath']
anaphylaxis --> ['fast heart rate', 'feeling of impending doom', 'itching', 'tongue swelling', 'difficulty swallowing', 'facial swelling', 'impaired voice', 'mental confusion', 'nasal congestion']
ankylosing spondylitis --> ['bone tissue formation', 'fatigue', 'hunched back', 'inflamed tendons', 'inflammatory bowel disease', 'physical deformity', 'sleep disorder']
anorexia nervosa --> ['brittle nails', 'bruising', 'depression', 'dieting', 'dry hair', 'dry skin', 'headache', 'sensitivity to cold', 'slow heart rate']
anthrax --> ['coughing', 'headache', 'itching', 'nausea', 'sore throat', 'swollen lymph nodes', 'fever', 'malaise']
anxiety --> ['anxiety', 'excessive worry', 'fear', 'feeling of impending doom', 'insomnia', 'nausea', 'palpitations', 'trembling']
aortic stenosis --> ['chest pressure', 'shortness of breath', 'fainting', 'fatigue', 'inability to exercise', 'light headedness']
aplastic anemia --> ['bleeding', 'bruising', 'fast heart rate', 'frequent infections', 'nosebleed', 'pallor', 'shortness of breath', 'rash of small purplish spots', 'red spots']
appendicitis --> ['abdominal pain migration', 'chills', 'fever', 'loss of appetite', 'malaise', 'diarrhoea', 'nausea', 'vomiting']
arrhythmia --> ['shortness of breath', 'dizziness', 'fainting', 'light headedness']
arteriovenous malformations --> ['dizziness', 'headache', 'seizures']
arthritis --> ['flare', 'physical deformity', 'redness', 'stiff neck', 'fatigue', 'malaise']
asperger’s syndrome --> ['depression', 'intense interest in a limited number of things', 'learning disability', 'nightmares', 'sensitivity to sound']
asthma --> ['chest pressure', 'flare', 'anxiety', 'early awakening', 'fast heart rate', 'throat irritation']
astigmatism --> ['blurred vision', 'eye strain', 'headache']
atherosclerosis --> ['erectile dysfunction (impotence)', 'heart attack', 'mini strokes (transient ischaemic attacks)', 'poor wound healing', 'stroke']
athlete's foot --> ['infection', 'itching', 'stinging sensation', 'swelling', 'rashes', 'dryness', 'fissures', 'peeling', 'stinging']
atopic eczema --> ['itching', 'rashes', 'dryness', 'flakiness', 'bumps', 'fissures', 'peeling', 'redness']
atrial septal defect --> ['failure to thrive', 'fatigue', 'stroke']
autism --> ['anxiety', 'change in voice', 'sensitivity to sound', 'tic']
avian influenza --> ['coughing', 'headache', 'shortness of breath', 'sore throat', 'fever', 'malaise']
bacterial meningitis --> ['fever', 'chills', 'fatigue', 'lethargy', 'loss of appetite', 'malaise', 'shivering', 'nausea', 'vomiting']
bacterial vaginosis --> ['vaginal burning']
bed bug bite --> ['itching', 'swelling', 'small bump', 'redness']
bedsores --> ['chronic wound', 'swelling', 'redness', 'dark scab', 'ulcer of ankle', 'ulcer of coccyx', 'ulcer of heel and mid foot', 'ulcer of hip']
bell's palsy --> ['facial muscle weakness', 'drooling', 'dry eyes', 'ear pain']
benign prostate enlargement --> ['incontinence', 'sexual dysfunction']
bile duct cancer (cholangiocarcinoma) --> ['dark urine', 'itching', 'pale faeces', 'weight loss', 'yellow skin and eyes', 'fever', 'weakness']
bipolar disorder --> ['fatigue', 'rapid and frenzied speaking']
blepharitis --> ['crusty eyelashes', 'peeling skin', 'eyes pain']
blood poisoning (sepsis) --> ['delirium', 'fast heart rate', 'insufficient urine production', 'organ dysfunction', 'skin discolouration', 'sleepiness']
boil --> ['pus', 'tenderness', 'pimples', 'redness']
bone cancer --> ['bone fracture', 'feeling tired', 'limping', 'swelling', 'weight loss']
bovine spongiform encephalopathy (bse) --> ['impaired voice', 'insomnia', 'restlessness', 'unresponsiveness']
bowel cancer --> ['abdominal discomfort', 'weight loss', 'anaemia', 'fatigue', 'blood in stool', 'change in bowel habits', 'constipation', 'narrow stools', 'passing excessive amounts of gas']
bowel polyps --> ['blood in stool']
brain tumors --> ['blurred vision', 'difficulty speaking', 'personality change', 'seizures', 'sleepiness', 'dizziness', 'fatigue', 'vertigo']
breast cancer --> ['redness', 'swollen lymph nodes', 'thickening', 'puckering of the skin']
bronchiectasis --> ['phlegm', 'recurrent infection', 'deformity of nails', 'weight loss', 'fatigue', 'inability to exercise']
bronchiolitis-rsv --> ['coughing', 'nasal congestion', 'dehydration', 'fever', 'loss of appetite', 'malaise']
bronchitis --> ['chest pressure', 'headache', 'shortness of breath', 'sleeping difficulty', 'sore throat', 'fatigue', 'malaise']
brucella infection [brucellosis] --> ['coughing', 'headache', 'swollen lymph nodes', 'weight loss', 'fever', 'chills', 'fatigue', 'loss of appetite', 'night sweats']
bulimia --> ['abnormality of taste', 'depression', 'poor self esteem', 'sore throat', 'dehydration', 'fatigue', 'food aversion', 'hunger', 'water electrolyte imbalance']
bunion --> ['redness', 'tenderness', 'joints pain']
burn --> ['sensitivity to pain', 'swelling', 'tenderness', 'flushing', 'sweating', 'blister', 'peeling', 'total loss of colour', 'redness']
c --> ['depression', 'weight loss', 'fatigue', 'fever', 'loss of appetite', 'bleeding', 'bloating', 'fluid in the abdomen', 'nausea']
c. diff. infection [clostridium difficile infection] --> ['fever', 'diarrhoea', 'bloating', 'blood in stool']
calcium elevated (hypercalcemia) --> ['excess urination', 'mental confusion', 'muscle weakness', 'weight loss', 'dehydration', 'fatigue', 'loss of appetite', 'thirst']
cancer in lung (lung cancer) --> ['hoarseness', 'swollen lymph nodes', 'weakness', 'weight loss', 'fatigue', 'loss of appetite']
canker sores --> ['mouth ulcer', 'mouth pain']
carcinoid syndrome --> ['coughing', 'flushing', 'swollen blood vessels in the skin', 'weight loss', 'bloating', 'bowel obstruction', 'diarrhoea', 'nausea', 'vomiting']
cardiomyopathy --> ['coughing', 'shortness of breath', 'swelling in extremities', 'weight gain', 'dizziness', 'fatigue', 'loss of appetite', 'bloating', 'fluid in the abdomen']
cardiomyopathy (hypertrophic) --> ['shortness of breath', 'dizziness', 'fatigue', 'inability to exercise']
cardiospasm (achalasia) --> ['difficulty swallowing', 'difficulty belching', 'weight loss', 'heartburn', 'regurgitation']
carpal tunnel syndrome --> ['hand numbness', 'sensation of pins and needles', 'hand clumsiness', 'hand pain at night', 'hand weakness', 'wrist weakness']
cat scratch disease --> ['swollen lymph nodes', 'small bump on skin', 'fatigue', 'fever']
cauliflower ear --> ['physical deformity', 'swelling', 'bruising']
causes chronic sinusitis --> ['sinus pressure', 'headache', 'inflammation of ear', 'mouth breathing', 'phlegm', 'pus', 'sleeping difficulty', 'throat irritation']
causes for hypothyroidism --> ['fatigue', 'lethargy', 'feeling cold']
causes of rheumatoid arthritis --> ['flare', 'dry mouth', 'physical deformity', 'sensation of pins and needles', 'fatigue', 'anaemia', 'malaise', 'lumps', 'redness']
celiac disease (gluten enteropathy) --> ['cramping', 'itching', 'lactose intolerance', 'skin rash', 'weight loss', 'bone loss', 'fatigue', 'malnutrition']
cellulite --> ['localized accumulation of fat', 'skin dimpling', 'overweight']
cellulitis --> ['pus', 'chills', 'fever', 'malaise', 'warmness', 'blister', 'red rashes', 'swelling']
cervical cancer --> ['fatigue', 'nausea', 'weight loss', 'pelvis pain']
cf (cystic fibrosis) --> ['acute bronchitis', 'deformity of nails', 'infection', 'male infertility', 'nasal polyps', 'pneumonia', 'salty sweat', 'weight loss']
cfs (chronic fatigue syndrome) --> ['depression', 'headache', 'muscle weakness', 'sensitivity to pain', 'sore throat', 'fatigue', 'inability to exercise', 'malaise']
chagas disease --> ['headache', 'painless swelling around eye', 'palpitations', 'skin rash', 'fever', 'body ache']
chalazion --> ['lump on the eyelid', 'eyelid redness']
charcot-marie-tooth disease --> ['hand contractures', 'slow reflexes', 'tremor']
chiari malformation --> ['difficulty swallowing', 'headache', 'impaired voice', 'nausea', 'rapid involuntary eye movement', 'ringing in the ears', 'vertigo']
chickenpox --> ['headache', 'itching', 'sore throat', 'swollen lymph nodes', 'fatigue', 'fever', 'loss of appetite']
chikungunya --> ['headache', 'persistent joint pain', 'skin rash', 'fever', 'chills', 'fatigue']
chilblains --> ['itching', 'swelling', 'rashes', 'redness', 'blister', 'ulcers']
childhood obesity --> ['overweight', 'binge eating', 'pot belly', 'shortness of breath']
children separation anxiety (separation anxiety) --> ['crying', 'nightmares', 'palpitations', 'rapid breathing']
chlamydia [chlamydia trachomatis disease] --> ['eye discharge', 'spotting', 'eyes pain', 'lower abdomen pain', 'pelvis pain', 'testicle pain', 'vagina pain']
chloasma (melasma) --> ['darkening of the skin']
cholelithiasis (gallstones) --> ['indigestion', 'nausea', 'vomiting', 'back pain', 'upper right abdomen pain']
cholera --> ['dehydration', 'lethargy', 'water electrolyte imbalance', 'nausea', 'severe diarrhoea', 'vomiting', 'watery diarrhoea']
cholesterol --> ['heart attack', 'peripheral artery disease', 'stroke']
chorea huntington (huntington disease) --> ['difficulty speaking', 'memory loss', 'tremor', 'weight loss']
chronic kidney disease --> ['kidney damage', 'abnormal heart rhythm', 'failure to thrive', 'fluid in the lungs', 'insufficient urine production', 'itching', 'kidney failure', 'severe unintentional weight loss', 'swelling']
chronic lymphocytic leukaemia --> ['swollen lymph nodes', 'fatigue']
chronic myeloid leukaemia --> ['bleeding', 'bruising', 'pallor', 'reduced ability to exercise', 'shortness of breath', 'weight loss']
chronic obstructive pulmonary disease --> ['chest pressure', 'loss of muscle', 'weight loss', 'fatigue', 'inability to exercise']
chronic pain --> ['anxiety', 'fatigue', 'headache', 'sleep deprivation']
cirrhosis --> ['fatigue', 'loss of appetite', 'reduced hormone production', 'web of swollen blood vessels in the skin', 'yellow skin and eyes']
cjd (creutzfeldt-jakob disease) --> ['blurred vision', 'difficulty speaking', 'insomnia', 'personality change', 'rapid involuntary eye movement']
cleft lip and cleft palate --> ['physical deformity', 'baby feeding difficulties', 'hearing loss', 'mouth breathing', 'nasal congestion', 'snoring']
clinical depression (depression) --> ['poor appetite', 'repeatedly going over thoughts', 'excessive hunger', 'fatigue', 'loss of appetite']
clubfoot --> ['foot deformity', 'abnormality walking', 'callus', 'knock knees', 'shortened legs']
cluster headaches --> ['headache', 'agitation', 'runny nose', 'flushing', 'nervous system dysfunction', 'sweating']
coarctation of the aorta --> ['blue skin from poor circulation', 'diminished pulses', 'failure to thrive', 'shortness of breath', 'high blood pressure', 'low blood pressure']
cold (common cold) --> ['chest pressure', 'headache', 'swollen lymph nodes', 'throat irritation', 'chills', 'fatigue', 'fever', 'malaise', 'body ache']
cold sore --> ['burning sensation', 'blister', 'rashes', 'ulcers', 'redness']
colitis ulcerative (ulcerative colitis) --> ['cramping', 'weight loss', 'anaemia', 'fatigue', 'fever', 'loss of appetite']
colonic diverticulitis (diverticulosis) --> ['change in bowel habits', 'constipation', 'abdomen pain']
color blindness --> ['color blindness']
compartment syndrome --> ['swelling', 'internal bleeding', 'muscle weakness', 'nerve injury', 'pallor', 'sensation of pins and needles']
complex regional pain syndrome --> ['depression', 'headache', 'redness', 'stiffness', 'swelling', 'tenderness', 'nervous system dysfunction', 'sweating']
compulsive obsessive disorder (obsessive compulsive disorder (ocd)) --> ['food aversion', 'nightmares', 'repeatedly going over thoughts']
concussion --> ['irritability', 'mild depression', 'ringing in the ears', 'sensitivity to light', 'blackout', 'fatigue', 'poor balance', 'nausea', 'vomiting']
congenital adrenal hyperplasia --> ['enlarged clitoris', 'inappropriate male features', 'insufficient amount of cortisol hormones', 'irregular menstruation', 'vomiting', 'dehydration', 'low blood pressure', 'low blood sugar', 'water electrolyte imbalance']
congenital megacolon (hirschsprung disease) --> ['failure to thrive', 'bloating', 'constipation', 'newborn unable to pass first stool', 'leaking of stool', 'vomiting', 'flatulence']
conjoined twins --> ['physical deformity']
conjunctivitis --> ['sensitivity to light', 'eyes pain']
contact dermatitis --> ['itching', 'swelling', 'rashes', 'redness', 'blister', 'fissures', 'hives', 'peeling', 'ulcers']
contagious hepatitis b (is hepatitis b contagious) --> ['fluid in the abdomen', 'fatigue', 'malaise', 'web of swollen blood vessels in the skin', 'yellow skin and eyes']
cooley's anemia --> ['failure to thrive', 'iron overload', 'pallor', 'shortness of breath', 'yellow skin and eyes', 'anaemia', 'fatigue', 'weakness']
corneal inflammation (keratitis) --> ['eyes pain']
corns --> ['thickness', 'dryness']
coronary heart disease --> ['fast heart rate', 'shortness of breath', 'light headedness', 'sweating', 'indigestion', 'nausea']
costochondritis (costochondritis and tietze syndrome) --> ['tenderness', 'chest pain', 'rib pain']
cradle cap --> ['white', 'yellow scales on scalp', 'dandruff', 'rashes', 'oily skin', 'dryness', 'flakiness', 'redness']
crohn disease (crohn's disease) --> ['cramping', 'depression', 'flare', 'mouth ulcer', 'slow growth', 'weight loss', 'fatigue', 'fever', 'loss of appetite']
crossed eyes (strabismus) --> ['both eyes not focused on same object at same time', 'eye strain', 'headache']
croup --> ['agitation', 'drooling', 'phlegm', 'sore throat', 'fatigue', 'fever']
cushing's syndrome --> ['excess sweating', 'excessive hairiness', 'excessive hunger', 'fatigue', 'flushing', 'high blood pressure', 'osteoporosis']
cysticercosis --> ['headache', 'lump', 'seizures', 'swelling of optic disc', 'nausea', 'vomiting']
cystocele (fallen bladder) --> ['pelvic pressure', 'vaginal bulge']
d --> ['fatigue', 'muscle weakness', 'muscles pain']
deep vein thrombosis --> ['swelling in extremities', 'tenderness', 'warm skin', 'calf pain', 'foot pain', 'leg pain']
dementia --> ['memory loss', 'falling', 'jumbled speech', 'sleep disorder']
dengue --> ['easy bruising', 'headache', 'chills', 'fatigue', 'fever', 'loss of appetite', 'nausea', 'vomiting']
dental abscess --> ['pus', 'fever', 'swollen lymph nodes', 'jaw pain']
dermatitis herpetiformis --> ['itching', 'rashes', 'blister', 'darkening of the skin', 'small bump', 'redness']
diabetic retinopathy --> ['new and abnormal blood vessels']
diaper rash --> ['itchiness around anus', 'rashes', 'blister', 'peeling', 'pimples', 'redness']
diphtheria --> ['coughing', 'muscle weakness', 'runny nose', 'swelling', 'swollen lymph nodes', 'chills', 'fatigue', 'fever', 'malaise']
discoid eczema --> ['lesion', 'itching', 'dryness', 'flakiness', 'rashes', 'redness', 'coin shaped rashes', 'darkening of the skin']
dog bites --> ['bleeding', 'bruising', 'infection', 'redness', 'swelling']
duchenne muscular dystrophy --> ['constantly walking on tip toe', 'difficulty swallowing', 'enlarged calves', 'fatigue', 'frequent falls', 'scoliosis']
dystonia --> ['eyelid twitching', 'torticollis', 'twisting movements', 'voice box spasms']
e --> ['dark urine', 'yellow skin and eyes', 'fatigue', 'fever', 'loss of appetite', 'nausea', 'pale faeces', 'vomiting']
ear - swimmer's --> ['feeling of fullness in the ear', 'hearing loss', 'itching', 'redness', 'tenderness']
ear infection [otitis media] --> ['crying', 'headache', 'nasal congestion', 'nausea', 'fever', 'loss of appetite', 'vertigo']
early pregnancy loss --> ['cramping', 'irregular uterine bleeding', 'fatigue', 'nausea', 'vomiting']
ebola virus disease --> ['coughing up blood', 'eye redness', 'headache', 'mental confusion', 'red spots on skin', 'sore throat']
echinococcosis --> ['coughing', 'nausea', 'shortness of breath', 'weakness']
eclampsia --> ['blurred vision', 'headache', 'nausea', 'swelling in extremities', 'weight gain', 'high blood pressure', 'fatigue']
ectopic pregnancy --> ['abnormal vaginal bleeding', 'cramping', 'bloating', 'nausea', 'vomiting']
endocarditis --> ['heart murmur', 'fever', 'chills', 'fatigue', 'malaise', 'night sweats']
endometriosis --> ['infertility', 'constipation', 'nausea', 'lower abdomen pain', 'lower back pain', 'pelvis pain', 'rectum pain', 'vagina pain']
epilepsy --> ['seizures', 'amnesia', 'anxiety', 'depression', 'staring spells', 'fainting', 'fatigue']
erectile dysfunction (impotence) --> ['soft erections', 'trouble getting an erection', 'trouble maintaining an erection', 'anxiety']
ewing sarcoma --> ['limping', 'palpable soft tissue mass', 'swelling', 'back pain', 'bones pain', 'joints pain']
eye injury --> ['black eye', 'bleeding', 'swelling', 'eyes pain']
farsightedness (or hyperopia) --> ['headache']
fibroids --> ['abdominal distension', 'cramping', 'abdomen pain', 'lower back pain', 'pelvis pain']
fibromyalgia --> ['depression', 'flare', 'headache', 'irritability', 'joint stiffness', 'painful menstruation', 'sensitivity to cold', 'tingling feet']
fifth disease-viral rash --> ['rash on the face', 'coughing', 'headache', 'itching', 'nausea', 'runny nose', 'sore throat', 'fever', 'fatigue']
filariasis --> ['swelling', 'swollen lymph nodes']
flatfoot --> ['foot pain']
flu --> ['chest pressure', 'head congestion', 'headache', 'nausea', 'shortness of breath', 'sore throat', 'swollen lymph nodes']
food allergy --> ['baby colic', 'cramping', 'flushing', 'itching', 'tingling lips', 'hives', 'rashes']
food poisoning --> ['headache', 'weakness', 'abdomen pain', 'rectum pain']
fracture (bone fracture) --> ['bleeding', 'bruising', 'limping', 'loss of height', 'physical deformity', 'swelling', 'tenderness']
frey's syndrome --> ['excess sweating', 'flushing', 'nervous system dysfunction']
frost bite --> ['blistering', 'feeling cold', 'waxy skin', 'blue skin from poor circulation', 'stinging', 'redness']
fungal diseases [mycotic diseases] --> ['deformed toenail', 'itching', 'vaginal discharge', 'darkening of the skin', 'loss of colour', 'peeling', 'rashes', 'small bump']
gallbladder cancer --> ['itching', 'lump in the abdomen', 'weight loss', 'yellow skin and eyes', 'fever', 'loss of appetite', 'malaise']
ganglion cyst --> ['lump', 'pain in the affected area', 'wrist pain']
gangrene --> ['creaky joints', 'foul smelling discharge', 'pus', 'reduced sensation of touch', 'fever', 'low blood pressure']
gastro-esophageal reflux disease (gerd) --> ['bitter taste', 'discomfort in upper abdomen', 'dry cough', 'belching', 'heartburn', 'nausea', 'regurgitation']
gastroenteritis --> ['fast heart rate', 'headache', 'insufficient urine production', 'weakness', 'weight loss']
generalized anxiety disorder (gad) --> ['emotional distress', 'excessive worry', 'difficulty falling asleep', 'headache', 'nausea', 'palpitations', 'repeatedly going over thoughts', 'trembling']
genital candidiasis --> ['redness', 'vagina pain']
genital herpes --> ['genital sores', 'sensation of pins and needles', 'skin rash', 'penis pain', 'vagina pain']
genital warts --> ['warts and verrucas', 'itchiness around anus', 'itching', 'itching of vagina', 'skin burning sensation']
german measles (rubella virus) --> ['enlarged neck lymph nodes', 'eye redness', 'headache', 'red rashes', 'runny nose', 'fever', 'malaise']
gestational diabetes --> ['fetal macrosomia', 'frequent urination', 'thrush in men and women', 'excessive hunger', 'excessive thirst', 'fatigue']
giardia infection [giardiasis] --> ['cramping', 'foul smelling stool', 'weight loss', 'fatigue', 'loss of appetite', 'malaise', 'malnutrition']
glandular fever --> ['sore throat', 'swollen lymph nodes', 'swollen tonsils', 'headache', 'nausea']
goitre --> ['coughing', 'fast heart rate', 'inability to tolerate heat', 'shortness of breath', 'throat tightness', 'underactive thyroid', 'weight gain']
gonorrhea --> ['fever', 'frequent urge to urinate', 'irregular menstruation', 'pus', 'sore throat']
gout --> ['physical deformity', 'redness', 'joints pain', 'ankle pain', 'foot pain', 'knee pain', 'toe pain']
group b strep infection (gbs) [group b streptococcal infection] --> ['low birth weight', 'pneumonia', 'skin rash', 'urinary tract infections (utis)', 'vaginal discharge', 'fever', 'lethargy']
guillain-barré syndrome --> ['difficulty raising the foot', 'difficulty speaking', 'difficulty swallowing', 'facial muscle weakness', 'shortness of breath', 'slow reflexes', 'uncomfortable tingling and burning', 'urinary retention']
guinea --> ['fever', 'itching', 'diarrhoea', 'nausea', 'vomiting', 'worm emerging from a skin blister', 'blister', 'ulcers', 'hives']
gum disease --> ['dental plaque', 'redness']
h1n1 flu --> ['headache', 'shortness of breath', 'sore throat', 'chills', 'fatigue', 'fever', 'diarrhoea', 'nausea', 'vomiting']
haemophilia --> ['bleeding', 'blood in stool', 'blood in urine', 'bruising', 'heavy', 'prolonged periods', 'internal bleeding', 'nosebleed', 'swollen joint']
haemorrhoids (piles) --> ['constipation', 'rectum pain']
hand, foot and mouth disease --> ['canker sore', 'coughing', 'headache', 'irritability', 'sore throat', 'blister', 'peeling', 'rashes', 'red spots']
hansen's disease --> ['nerve injury', 'weight loss', 'blister', 'loss of colour', 'rashes', 'ulcers', 'redness']
hantavirus pulmonary syndrome (hps) --> ['coughing', 'headache', 'fever', 'chills', 'fatigue', 'low blood pressure', 'malaise']
hashimoto's thyroiditis --> ['dryness', 'roughness']
head and neck cancer --> ['enlarged neck lymph nodes', 'hoarseness', 'mouth ulcer', 'ear pain']
head lice --> ['itching', 'skin bumps']
heart failure --> ['excess urination at night', 'palpitations', 'swollen feet', 'swollen legs', 'weight gain', 'dizziness', 'fatigue', 'inability to exercise', 'loss of appetite']
heat rash --> ['flushing', 'itching', 'rashes', 'blister', 'bumps', 'red rashes']
hemangioma --> ['birthmark', 'bleeding']
heroin --> ['physical substance dependence', 'chronic constipation', 'small pupils', 'nausea', 'reduced sex drive', 'sensitivity to pain', 'shallow breathing', 'slurred speech']
hiatus hernia --> ['throat irritation', 'belching', 'heartburn', 'hiccup', 'nausea', 'regurgitation', 'vomiting']
hip fractures --> ['abnormality walking', 'bruising', 'swelling', 'visible deformity of lower extremity']
hives --> ['swelling', 'itching', 'flare', 'raised area of skin', 'inflammation in response to touch']
hodgkin lymphoma --> ['itching', 'night sweats', 'swollen lymph nodes', 'weight loss', 'fatigue', 'fever', 'loss of appetite']
horner syndrome --> ['inability to sweat normally', 'nerve injury', 'blurred vision']
hpv infection (human papillomavirus infection) --> ['itching', 'warts and verrucas']
hydrocele --> ['swollen testicle', 'testicular discomfort']
hydrocephalus --> ['nausea', 'vomiting']
hypoglycaemia (low blood sugar) --> ['excess sweating', 'excessive hunger', 'fainting', 'fatigue', 'light headedness', 'shakiness', 'nausea', 'vomiting']
ic (interstitial cystitis) --> ['bladder pain', 'pelvis pain', 'penis pain', 'testicle pain']
ichthyosis --> ['hyperlinearity of palms and soles', 'itching', 'thickened skin on palms and soles', 'flakiness', 'dryness', 'fissures', 'peeling']
immune thrombocytopenia --> ['bleeding', 'bruising', 'heavy', 'prolonged periods', 'nosebleed', 'red spots', 'rash of small purplish spots']
impetigo --> ['itching', 'red rashes', 'blister']
infertility --> ['inability to get pregnant', 'anxiety']
ingrown toenail --> ['redness', 'swelling', 'tenderness', 'limping']
inguinal hernia --> ['swollen lymph nodes in the groin', 'groin pain', 'pelvis pain', 'testicle pain']
insect bite --> ['itching', 'stinging sensation', 'swelling', 'rashes', 'redness']
insomnia --> ['sleeping difficulty', 'depression', 'headache', 'irritability']
insulin resistance --> ['obesity', 'absence of menstruation', 'excessive hairiness', 'lipodystrophy', 'skin tags']
intrauterine growth restriction (iugr) --> ['low birth weight']
intussusception --> ['baby colic', 'crying', 'fatigue', 'lethargy', 'loss of appetite']
iron deficiency anemia --> ['brittle nails', 'pallor', 'shortness of breath', 'dizziness', 'fatigue', 'light headedness']
irritable bowel syndrome --> ['anxiety', 'depression', 'discomfort', 'loss of appetite', 'symptoms alleviated by defecation']
japanese encephalitis --> ['headache', 'nausea']
jock itch --> ['itching', 'groin rash', 'redness']
kala-azar/ leishmaniasis --> ['abnormally thin', 'darkening of the skin', 'diarrhoea', 'swollen lymph nodes', 'fever', 'loss of appetite', 'low blood counts', 'malaise', 'night sweats']
kaposi's sarcoma --> ['coughing', 'fever', 'mouth ulcer', 'plaque', 'shortness of breath', 'swollen lymph nodes']
kawasaki disease --> ['fever', 'high fever', 'diarrhoea', 'vomiting', 'peeling', 'red rashes']
keratoconjunctivitis sicca (dry eye syndrome) --> ['sensitivity to light', 'eyes pain']
keratoconus --> ['a rim of discolouration around the front of the eye (fleischer ring)']
keratosis pilaris --> ['follicular papules', 'darkening of the skin', 'dryness', 'pimples', 'redness']
kidney infection --> ['fast heart rate', 'chills', 'fever', 'fatigue', 'loss of appetite', 'malaise', 'nausea', 'vomiting']
kidney stone --> ['sweating', 'nausea', 'vomiting', 'back pain', 'side part of the body pain']
kyphosis --> ['physical deformity', 'compression fracture', 'falling', 'short stature', 'stiffness', 'mobility disability']
labyrinthitis --> ['dizziness', 'hearing loss', 'rapid involuntary eye movement', 'nausea', 'vomiting']
lactose intolerance --> ['baby colic', 'malaise', 'belching', 'bloating', 'diarrhoea', 'fat in stool', 'indigestion', 'flatulence', 'stomach cramps']
laryngitis --> ['phlegm', 'sleeping difficulty', 'swollen lymph nodes', 'fever', 'malaise']
latex allergies --> ['itching', 'throat irritation', 'watery eyes', 'blister', 'rashes', 'redness']
lead --> ['baby colic', 'headache', 'insomnia', 'memory loss', 'fatigue', 'loss of appetite', 'constipation', 'nausea', 'vomiting']
leg cramps --> ['muscles pain']
legionnaires' disease [legionellosis] --> ['shortness of breath', 'coughing', 'headache', 'mental confusion', 'fever', 'chills', 'diarrhoea', 'nausea', 'vomiting']
leptospira infection [leptospirosis] --> ['headache', 'red eyes', 'skin rash', 'sore throat', 'chills', 'fatigue', 'high fever']
leukemia --> ['dizziness', 'fatigue', 'fever', 'loss of appetite']
lichen planus --> ['hair loss', 'itching', 'mouth ulcer']
liver cancer --> ['itching', 'weight loss', 'yellow skin and eyes', 'cancer related fatigue', 'fatigue', 'loss of appetite']
liver failure --> ['mental confusion', 'yellow skin and eyes', 'bad breath from liver disease', 'bleeding', 'bruising', 'flapping hand tremor', 'itching', 'swelling']
long qt syndrome --> ['seizures', 'dizziness', 'fainting', 'feeling faint']
lupus --> ['anaemia', 'fatigue', 'fever', 'malaise', 'red rashes', 'scaly rashes']
lyme disease --> ["bull's eye pattern rash", 'headache', 'fatigue', 'fever', 'malaise']
lymphedema --> ['swelling in extremities', 'frequent skin infections of affected limb', 'swollen lymph nodes', 'water retention', 'dimpled skin like an orange peel', 'rashes']
malaria --> ['fast heart rate', 'headache', 'mental confusion', 'pallor', 'diarrhoea', 'nausea', 'vomiting']
malnutrition --> ['weight loss', 'dizziness', 'fatigue', 'water electrolyte imbalance']
malocclusion --> ['misaligned teeth', 'physical deformity', 'jaw pain']
marfan syndrome --> ['back pain']
mastitis --> ['pus', 'swelling', 'chills', 'fatigue', 'fever', 'malaise', 'warmness', 'redness']
md (muscular dystrophy) --> ['cardiomyopathy', 'constantly walking on tip toe', 'constipation', 'difficulty swallowing', 'fatigue', 'scoliosis', 'shallow breathing']
measles --> ['skin rash', 'conjunctivitis', 'dry cough', 'diarrhoea', 'headache', "koplik's spots", 'sensitivity to light', 'sore throat', 'swollen lymph nodes']
meniere's disease --> ['hearing loss', 'imbalance', 'motion sickness', 'nausea', 'rapid involuntary eye movement', 'vertigo', 'dizziness']
meniscal tears --> ['swollen knee', 'stiffness', 'knee pain']
menopause --> ['anxiety', 'dry skin', 'irritability', 'moodiness', 'reduced sex drive', 'vaginal dryness']
mental retardation --> ['difficulty thinking and understanding']
mesothelioma --> ['coughing', 'shortness of breath', 'weight loss', 'fatigue', 'loss of appetite', 'night sweats', 'bloating', 'nausea']
microcephaly --> ['misshapen face', 'hearing loss', 'intellectual disability', 'malnutrition', 'poor coordination', 'speech impairment', 'vision disorder']
migraine --> ['irritability', 'nasal congestion', 'scalp tenderness', 'dizziness', 'light headedness', 'malaise', 'nausea', 'vomiting']
molluscum contagiosum --> ['small bump', 'lumps', 'redness']
motion sickness --> ['headache', 'pallor', 'palpitations', 'balance disorder', 'dizziness', 'malaise', 'nausea', 'belching', 'vomiting']
mouth cancer --> ['coughing', 'enlarged neck lymph nodes', 'ear pain', 'mouth pain', 'mouth and face pain']
multiple myeloma --> ['constipation', 'hypercalcemia', 'increased risk of infection', 'kidney damage', 'weight loss', 'anaemia', 'fatigue', 'loss of appetite']
multiple sclerosis --> ['fatigue', 'dizziness', 'heat intolerance', 'poor balance', 'vertigo']
mumps --> ['dry mouth', 'headache', 'hearing loss', 'neck swelling', 'swollen lymph nodes', 'swollen salivary glands']
myelomeningocele --> ['hunched back', 'intellectual disability', 'nerve injury', 'paralysis', "paralysis of the body's lower half", 'physical deformity', 'bowel obstruction', 'constipation', 'leaking of stool']
myocardial infarction (heart attack) --> ['anxiety', 'chest pressure', 'feeling of impending doom', 'palpitations', 'shortness of breath', 'shoulder discomfort']
myocarditis --> ['swelling in extremities', 'dizziness', 'fatigue', 'malaise']
myopia --> ['headache']
narcolepsy --> ['fatigue', 'hallucination']
nasal polyps --> ['abnormality of taste', 'headache', 'snoring', 'face pain']
neonatal respiratory disease syndrome(nrds) --> ['respiratory distress syndrome', 'blue skin from poor circulation', 'insufficient urine production', 'low birth weight']
neuroblastoma --> ['abdominal distension', 'coughing', 'failure to thrive', 'lump in the abdomen', 'pallor', 'shortness of breath', 'weight loss']
neuroendocrine tumours --> ['flushing', 'low blood sugar']
neurofibromatosis --> ['attention deficit hyperactivity disorder (adhd)', 'bone deformities', 'enlarged head', 'hearing loss', 'ringing in the ears', 'scoliosis', 'seizures', 'sensation of pins and needles', 'vision disorder']
neutropenia --> ['fever', 'mouth ulcer', 'sore throat', 'susceptibility to infection']
non-alcoholic fatty liver disease (nafld) --> ['fatigue']
non-hodgkin lymphoma --> ['b symptoms', 'night sweats', 'swollen lymph nodes', 'weight loss', 'anaemia', 'fatigue', 'loss of appetite']
oa (osteoarthritis) --> ['joint deformity', 'limping', 'joints pain', 'hands pain', 'hip pain', 'knee pain', 'lower back pain', 'neck pain']
obesity --> ['overweight', 'binge eating', 'fatigue', 'pot belly', 'snoring']
oesophageal cancer --> ['difficulty swallowing', 'iron deficiency anaemia', 'loss of appetite', 'weight loss', 'dark stool from digested blood', 'heartburn', 'indigestion', 'nausea', 'vomiting blood']
opioid overdose --> ['respiratory failure', 'slow breathing', 'small pupils', 'unresponsiveness', 'blue skin from poor circulation']
oppositional defiant disorder --> ['depression', 'problem paying attention']
osteomyelitis --> ['swelling', 'chills', 'fatigue', 'fever', 'malaise', 'night sweats', 'ulcers', 'redness']
osteoporosis --> ['bone fracture', 'loss of height']
osteosarcoma --> ['bone tissue formation', 'limping', 'swelling', 'bones pain', 'knee pain']
ovarian cancer --> ['weight loss', 'cancer related fatigue', 'loss of appetite', 'bloating', 'change in bowel habits', 'indigestion', 'nausea']
ovarian cyst --> ['cramping', 'excessive hairiness', 'back pain', 'pelvis pain', 'side part of the body pain']
overactive thyroid --> ['weight loss', 'diarrhoea', 'hair loss', 'muscle weakness', 'tremor', 'warm skin']
pad (peripheral arterial disease) --> ['cool skin', 'loss of hair on the legs', 'thinning of skin on the legs', 'ulcers']
pancreatic cancer --> ['dark urine', 'weight loss', 'yellow skin and eyes', 'fatigue', 'loss of appetite', 'fluid in the abdomen', 'nausea']
pancreatitis --> ['fast heart rate', 'weight loss', 'loss of appetite', 'sweating', 'bloating', 'fat in stool', 'indigestion', 'nausea', 'vomiting']
parkinson's disease --> ['fatigue', 'dizziness', 'poor balance', 'restlessness']
patent ductus arteriosus --> ['easy tiring', 'failure to thrive', 'lack of interest in feeding in infants', 'sweating with eating', 'crying']
pe (pulmonary embolism) --> ['dry cough', 'light headedness', 'low oxygen in the body']
pectus excavatum --> ['physical deformity', 'coughing', 'palpitations', 'shortness of breath', 'fatigue', 'inability to exercise']
pelvic inflammatory disease (pid) --> ['cramping', 'painful menstruation', 'chills', 'fatigue', 'fever', 'nausea', 'vomiting']
penile cancer --> ['penile lesion', 'discharge from wound', 'swollen lymph nodes', 'lumps', 'ulcers']
pericarditis --> ['chest pressure', 'shortness of breath', 'fatigue', 'fever']
peripheral neuropathy --> ['poor balance', 'slow reflexes', 'tingling feet', 'tingling fingers', 'weakness']
pertussis (whooping cough) --> ['paroxysmal cough', 'episodes of no breathing', 'vomiting', 'watery eyes', 'fatigue', 'fever']
plague --> ['bleeding', 'delirium', 'headache', 'phlegm', 'shortness of breath', 'swollen and tender lymph node', 'diarrhoea', 'nausea', 'vomiting']
pleurisy --> ['dry cough', 'fever', 'side part of the body pain']
polio infection [poliomyelitis infection] --> ['headache', 'nausea', 'slow growth', 'fatigue', 'feeling faint', 'fever', 'wasting away']
polycystic ovary syndrome (pcos) --> ['infertility', 'acne', 'dark patches of skin in folds and creases', 'depression', 'inappropriate male features', 'loss of scalp hair', 'oily skin', 'unwanted hair']
polymyalgia rheumatica --> ['joint stiffness', 'tenderness', 'fatigue', 'shoulder pain', 'neck pain', 'pelvic girdle pain']
post-traumatic stress disorder (ptsd) --> ['emotional detachment', 'unwanted thoughts']
postnatal depression --> ['insomnia', 'repeatedly going over thoughts', 'fatigue', 'loss of appetite']
postpartum haemorrhage --> ['vaginal bleeding', 'fast heart rate', 'low blood pressure']
premature birth [preterm birth] --> ['disproportionately large head compared to body size', 'infant respiratory distress syndrome', 'low body temperature in newborn', 'retinal damage in newborn']
premenstrual syndrome --> ['acne', 'depression', 'headache', 'insomnia', 'irritability', 'lack of concentration', 'moodiness', 'painful menstruation', 'weight gain']
prostate cancer --> ['bones pain']
psoriasis --> ['depression', 'inflamed tendons', 'itching', 'joint stiffness', 'plaque', 'small dents in nails']
psoriatic arthritis --> ['skin rash', 'fatigue', 'inflamed fingers', 'toes', 'itching', 'physical deformity', 'small dents in nails', 'tendonitis']
psychosis --> ['memory loss', 'nightmares', 'tactile hallucination']
pterygium --> ['blurred vision']
pulmonary hypertension --> ['chest pressure', 'chronic cough', 'fast heart rate', 'shortness of breath', 'swelling', 'swollen legs']
pyloric stenosis --> ['severe vomiting', 'baby colic', 'failure to thrive', 'insufficient urine production', 'lump in the abdomen', 'weight loss', 'water electrolyte imbalance', 'dehydration', 'lethargy']
q fever --> ['coughing', 'headache', 'nausea', 'shortness of breath', 'fatigue', 'high fever', 'malaise', 'chills', 'night sweats']
quinsy --> ['abscess', 'pus', 'swelling', 'swollen lymph nodes', 'deviated uvula', 'muffled voice', 'fever', 'chills', 'malaise']
rabies --> ['dizziness', 'fatigue', 'fever', 'loss of appetite', 'malaise', 'nausea', 'vomiting']
raynaud's phenomenon --> ['sensitivity to cold', 'lack of blood supply', 'pallor', 'red fingers', 'toes', 'reduced sensation of touch', 'throbbing pain in fingers']
reactive arthritis --> ['discharge from penis', 'eye redness', 'fever', 'inflamed tendons', 'skin rash']
restless legs syndrome --> ['charley horse', 'uncomfortable tingling and burning', 'urge to move', 'fatigue', 'restlessness']
retinoblastoma --> ['blurred vision']
rheumatic fever and rheumatic heart disease --> ['multiple joint inflammation', 'rash with pink rings and lines', 'sore throat', 'fatigue', 'fever', 'inability to exercise']
ringworm --> ['hair loss', 'itchy scalp', 'darkening of the skin', 'fissures', 'peeling', 'red rashes', 'scaly patches']
river blindness [onchocerciasis] --> ['itching', 'eye redness', 'swollen lymph nodes', 'bumps under the skin', 'rashes', 'scar']
rmsf (rocky mountain spotted fever) --> ['eye redness', 'headache', 'rash on the palms and soles', 'sensitivity to light', 'fever', 'chills', 'loss of appetite', 'nausea', 'vomiting']
rosacea --> ['photosensitivity', 'itching', 'large and bulbous red nose', 'red face', 'dryness', 'oily skin', 'rashes that look like acne', 'swollen blood vessels in the skin']
salmonella infection [salmonellosis] --> ['headache', 'chills', 'dehydration', 'fatigue', 'fever', 'loss of appetite', 'diarrhoea', 'blood in stool']
sarcoidosis --> ['coughing', 'swollen lymph nodes', 'weight loss', 'fatigue', 'malaise', 'night sweats', 'rashes', 'red and tender lumps']
sars [severe acute respiratory syndrome] --> ['coughing', 'infection', 'headache', 'fever', 'chills', 'malaise']
scabies --> ['itching', 'skin burrow', 'bumps', 'redness']
scarlet fever --> ['sore throat', 'circumoral pallor', 'enlarged neck lymph nodes', 'nausea', "swollen and bumpy tongue that's red", 'swollen tonsils', 'fever', 'flushing', 'malaise']
schistosomiasis [schistosoma infection] --> ['coughing', 'headache', 'infertility', 'itching', 'poor appetite', 'skin rash', 'vaginal bleeding', 'weight loss']
schizophrenia --> ['fatigue', 'impaired motor coordination', 'lack of emotional response', 'memory loss']
scoliosis --> ['leaning to one side', 'muscle spasms', 'physical deformity', 'uneven waist']
scorpion sting --> ['redness', 'itching', 'pain in the affected area', 'swelling']
scurvy --> ['bruising', 'coiled hair', 'failure to thrive', 'irritability', 'muscle weakness', 'swollen gums', 'weight loss', 'rashes', 'red spots']
septic shock --> ['fast heart rate', 'insufficient urine production', 'mental confusion', 'low blood pressure', 'chills', 'fatigue', 'fever', 'low body temperature']
shaken baby syndrome --> ['fainting', 'lethargy']
shingles --> ['painful red blister rash in linear distribution', 'burning sensation', 'fatigue', 'itching', 'blister', 'scab', 'ulcers', 'redness']
sickle cell disease --> ['abnormal breakdown of red blood cells', 'inflamed fingers', 'toes', 'pallor', 'shortness of breath', 'yellow skin and eyes']
sjogren's syndrome --> ['dry cough', 'dry eyes', 'dry skin', 'fatigue', 'joint stiffness', 'stiffness', 'swollen lymph nodes', 'vaginal dryness']
skin cancer (melanoma) --> ['bigger mole diameter', 'darkening of the skin', 'mole color changes', 'skin mole with irregular border']
sleeping sickness [african trypanosomiasis] --> ['fever', 'headache', 'itching', 'mental confusion', 'personality change', 'problems with coordination', 'skin rash', 'swollen lymph nodes']
smallpox --> ['headache', 'vomiting', 'fever', 'malaise', 'chills']
soil transmitted helminths --> ['blood in stool', 'loss of appetite', 'mild nausea', 'slow growth']
spider bite --> ['itching', 'swelling', 'redness', 'blister', 'small bump', 'pimples']
spinal cord injury --> ['abnormal and painful sensation', 'leaking of stool', 'shortness of breath', 'feeling faint', 'sweating']
spondylitis --> ['inflamed tendons', 'sleep disorder', 'back pain', 'neck pain']
stomach cancer --> ['abdominal fullness', 'difficulty swallowing', 'weight loss', 'cancer related fatigue', 'loss of appetite', 'dark stool from digested blood', 'indigestion', 'nausea', 'vomiting blood']
stomach ulcer --> ['abdominal discomfort', 'fatigue', 'feeling full sooner than normal', 'loss of appetite']
strep throat [group a strep infection] --> ['sore throat', 'enlarged neck lymph nodes', 'swollen tonsils', 'tender lymph nodes', 'tonsillar exudate', 'bad breath', 'headache', 'nausea', 'vomiting']
stroke --> ['difficulty swallowing', 'headache', 'inability to understand', 'mental confusion', 'rapid involuntary eye movement', 'fatigue', 'light headedness', 'vertigo']
sty --> ['lump on the eyelid', 'eyelid pain', 'eyelid tenderness']
sub-conjunctival haemorrhage --> ['eye redness']
sunburn --> ['blistering', 'itching', 'swelling']
supraventricular tachycardia --> ['fast heart rate', 'shortness of breath', 'fainting', 'fatigue', 'light headedness', 'sweating']
syphilis --> ['fatigue', 'itching', 'mouth ulcer', 'rash on the palms and soles', 'rectal lining inflammation', 'sore throat', 'swollen lymph nodes', 'weight loss']
t --> ['absence of menstruation', 'delayed puberty', 'depression', 'infertility', 'irritability', 'mood swings', 'pot belly', 'weight gain']
taeniasis/cysticercosis --> ['weight loss', 'nausea', 'passing worms in stool']
tb (tuberculosis) --> ['loss of muscle', 'phlegm', 'severe unintentional weight loss', 'shortness of breath', 'swollen lymph nodes']
tbi (traumatic brain injury) --> ['blackout', 'dizziness', 'fainting', 'fatigue', 'nausea', 'vomiting']
testicular cancer --> ['painless testicular lump', 'swelling of scrotum', 'swollen lymph nodes', 'weight loss', 'cancer related fatigue', 'fatigue']
tetanus --> ['lockjaw', 'abdominal rigidity', 'difficulty swallowing', 'drooling', 'fast heart rate', 'irritability', 'spasm with arched back and neck', 'stiff neck']
tetralogy of fallot --> ['baby feeding difficulties', 'shortness of breath', 'sudden deep blue discolouration', 'blue skin from poor circulation', 'deformity of nails', 'failure to thrive', 'fainting', 'inability to exercise']
thrush [oropharyngeal candidiasis] --> ['abnormality of taste', 'difficulty swallowing', 'redness']
thyroid cancer --> ['thyroid nodules', 'neck pain']
tonsillitis --> ['chills', 'fatigue', 'fever', 'malaise']
torticollis --> ['muscle spasms', 'physical deformity', 'stiffness', 'headache']
tourette syndrome (ts) --> ['coughing', 'eyelid twitching', 'frequent throat clearing', 'learning disability', 'repetitive blinking of eyes', 'stuttering']
trachoma --> ['eyelid scarring', 'mucus and pus discharge', 'eyes pain']
transient ischaemic attack (tia) --> ['difficulty swallowing', 'mental confusion', 'reduced sensation of touch', 'feeling faint', 'light headedness', 'vertigo']
treacher collins syndrome --> ['physical deformity', 'airway obstruction', 'cleft eyelid', 'difficulty swallowing', 'hearing loss', 'small ears', 'snoring', 'speech delay in a child']
trichomoniasis --> ['abdomen pain']
trigeminal neuralgia --> ['paroxysmal attack of facial pain', 'severe facial pain', 'sharp facial pain', 'unilateral facial pain', 'muscle spasms']
trigger thumb --> ['finger catching with sudden pop release', 'physical deformity', 'stiffness', 'lump', 'swelling', 'tenderness']
turners syndrome --> ['high blood pressure', 'osteoporosis']
type 1 diabetes --> ['blurred vision', 'fast heart rate', 'frequent infections', 'headache', 'sleepiness', 'weight loss', 'nausea', 'vomiting']
type 2 diabetes --> ['frequent urination', 'blurred vision', 'poor wound healing', 'excessive hunger', 'excessive thirst', 'fatigue']
typhoid / enteric fever --> ['headache', 'muscle weakness', 'rash with small red dots', 'skin rash', 'weight loss']
umbilical hernia --> ['soft swelling', 'bulge near the navel']
urinary tract infection --> ['cramping', 'vaginal irritation', 'fatigue', 'fever', 'malaise']
uterine cancer --> ['abnormal vaginal bleeding', 'weight loss', 'pelvis pain']
vaginitis --> ['vaginal erythema', 'vagina pain']
valley fever [coccidioidomycosis] --> ['coughing', 'headache', 'shortness of breath', 'weight loss', 'chills', 'fatigue', 'fever', 'night sweats']
varicose eczema --> ['itching', 'swelling', 'leg pain']
varicose veins --> ['bruising', 'heavy legs', 'itching', 'swollen legs', 'swollen blood vessels in the skin', 'discolouration']
venomous snakes --> ['pain in the affected area', 'redness', 'swelling', 'bleeding', 'bruising', 'fast heart rate', 'nausea', 'sweating']
ventricular septal defect --> ['baby feeding difficulties', 'blue skin from poor circulation', 'failure to thrive', 'swelling', 'fatigue', 'inability to exercise', 'sweating']
vitamin b12 deficiency --> ['memory loss', 'pallor', 'reduced sensation of touch', 'shortness of breath', 'tingling feet', 'anaemia', 'fatigue', 'poor balance']
vitiligo --> ['loss of skin colour', 'premature hair whitening']
von willebrand disease --> ['easy bruising', 'excessive bleeding during childbirth', 'heavy', 'prolonged periods', 'mouth bleeding', 'nosebleed', 'tendency to bleed easily']
vulval cancer --> ['lesion', 'skin ulcer', 'thickening of skin on vulva', 'genital area pain', 'pelvis pain']
warts --> ['itching', 'lesions in mouth', 'around genital regions', 'small growths on skin', 'thickness']
wegener's disease (granulomatosis with polyangiitis) --> ['blood in urine', 'hearing loss', 'kidney failure', 'mouth ulcer', 'unintentional weight loss', 'fatigue', 'fever']
wolff-parkinson-white syndrome --> ['shortness of breath', 'dizziness', 'light headedness']
yaws --> ['malaise', 'swelling', 'swollen lymph nodes', 'rashes', 'small bump', 'ulcers', 'scar']
yellow fever --> ['bleeding', 'delirium', 'headache', 'yellow skin and eyes', 'chills', 'fatigue', 'fever', 'loss of appetite']
