ACL injury --> ['bruising', 'limping', 'pain when standing', 'knee pain']
Abdominal aortic aneurysm --> ['nausea', 'pulsating abdominal mass', 'abdomen pain', 'back pain', 'flank pain']
Achalasia --> ['weight loss', 'difficulty swallowing', 'difficulty belching', 'heartburn', 'regurgitation', 'chest pain']
Acid reflux --> ['dry cough', 'bitter taste', 'discomfort in upper abdomen', 'nausea', 'heartburn', 'belching', 'regurgitation']
Acne --> ['pimple', 'blackhead', 'redness', 'pimples', 'tenderness']
Actinic keratosis --> ['itching', 'scaly patch on skin']
Acute Bronchitis --> ['headache', 'shortness of breath', 'sore throat', 'chest pressure', 'sleeping difficulty', 'fatigue', 'malaise']
Acute lymphoblastic leukemia --> ['weight loss', 'shortness of breath', 'swollen lymph nodes', 'pallor', 'infection', 'nosebleed', 'red spots on skin', 'easy bruising', 'bleeding gums']
Acute myeloid leukemia --> ['shortness of breath', 'bruising', 'bleeding', 'pallor', 'infection', 'red spots on skin', 'fatigue', 'fever', 'loss of appetite']
Addison's disease --> ['weight loss', 'muscle weakness', 'absence of menstruation', 'reduced sex drive', 'excess urination', 'craving salty foods', 'darkening of the skin', 'fatigue', 'loss of appetite']
Adult attention-deficit/hyperactivity disorder --> ['depression', 'learning disability', 'sleep deprivation', 'anxiety', 'mood swings', 'boredom', 'excitement', 'irritability', 'impulsivity']
Agoraphobia --> ['apprehension', 'panic attack', 'depression', 'fear', 'severe anxiety']
Alcohol use disorder --> ['tremor', 'physical substance dependence', 'slurred speech', 'problems with coordination', 'dizziness', 'sweating', 'blackout', 'shakiness', 'craving']
Allergic conjunctivitis --> ['blurred vision', 'sensitivity to light', 'redness', 'puffy eyes', 'watery eyes', 'itchiness']
Allergic rhinitis --> ['headache', 'itching', 'fatigue', 'coughing', 'throat irritation', 'phlegm', 'ear pain', 'wheezing', 'breathing through the mouth']
Allergy to mold --> ['shortness of breath', 'coughing', 'throat irritation', 'puffy eyes', 'watery eyes', 'itchiness']
Alopecia areata --> ['itching', 'anxiety', 'hair loss', 'small dents in nails']
Alzheimer's disease --> ['loss of appetite', 'jumbled speech', 'inability to combine muscle movements', 'mood swings', 'general discontent', 'anger', 'apathy', 'loneliness', 'irritability']
Amoebiasis --> ['weight loss', 'fatigue', 'fever', 'loss of appetite', 'diarrhoea', 'blood in stool', 'flatulence', 'abdomen pain']
Amyloidosis --> ['weight loss', 'bruising', 'swelling in extremities', 'organ dysfunction', 'tingling feet', 'diarrhoea', 'impaired voice', 'puffy eyes', 'abnormally large tongue']
Anal fissure --> ['cracked skin', 'rectum pain']
Anaphylaxis --> ['itching', 'fast heart rate', 'difficulty swallowing', 'mental confusion', 'nasal congestion', 'impaired voice', 'feeling of impending doom', 'tongue swelling', 'facial swelling']
Anemia --> ['headache', 'shortness of breath', 'pallor', 'weakness', 'brittle nails', 'fatigue', 'malaise', 'dizziness', 'light headedness']
Angelman syndrome --> ['seizures', 'sleep disorder', 'speech impairment', 'drooling', 'lazy eye', 'happy demeanour', 'problems with coordination', 'abnormality walking']
Angina --> ['fast heart rate', 'anxiety', 'chest pressure', 'fatigue', 'dizziness', 'sweating', 'light headedness', 'inability to exercise', 'nausea']
Ankylosing spondylitis --> ['fatigue', 'physical deformity', 'sleep disorder', 'inflamed tendons', 'hunched back', 'bone tissue formation', 'inflammatory bowel disease', 'joints pain', 'neck pain']
Anorexia nervosa --> ['headache', 'depression', 'bruising', 'sensitivity to cold', 'brittle nails', 'dry skin', 'slow heart rate', 'dry hair', 'dieting']
Antiphospholipid syndrome --> ['pain in the affected area', 'deep vein thrombosis', 'purplish skin discolouration', 'recurrent miscarriage', 'swelling of limb', 'chest pain', 'shortness of breath', 'blood clots in the lungs']
Antisocial personality disorder --> ['physical substance dependence', 'substance abuse', 'general discontent', 'anger', 'boredom', 'irritability', 'impulsivity', 'lack of restraint', 'aggression']
Anxiety disorder --> ['nausea', 'anxiety', 'palpitations', 'insomnia', 'feeling of impending doom', 'trembling', 'excessive worry', 'fear', 'fatigue']
Aortic dissection --> ['shortness of breath', 'nausea', 'acute severe chest pain', 'dizziness', 'fainting', 'low blood pressure', 'abdomen pain', 'middle back pain']
Aortic stenosis --> ['shortness of breath', 'chest pressure', 'fatigue', 'light headedness', 'fainting', 'inability to exercise', 'chest pain', 'murmur', 'enlarged heart']
Aphasia --> ['difficulty building and drawing things', 'loss of the ability to write', 'social isolation', 'persistent repetition of words', 'actions']
Appendicitis --> ['abdominal pain migration', 'fever', 'loss of appetite', 'malaise', 'chills', 'nausea', 'vomiting', 'diarrhoea', 'abdomen pain']
Arrhythmia --> ['shortness of breath', 'dizziness', 'light headedness', 'fainting', 'chest pain', 'palpitations', 'slow heart rate']
Arteriovenous malformation --> ['headache', 'dizziness', 'seizures']
Asperger syndrome --> ['depression', 'learning disability', 'nightmares', 'sensitivity to sound', 'inability to combine muscle movements', 'tic', 'poor coordination', 'anxiety', 'anger']
Asthma --> ['fast heart rate', 'anxiety', 'chest pressure', 'throat irritation', 'flare', 'early awakening', 'fast breathing', 'wheezing', 'rapid breathing']
Astigmatism --> ['headache', 'blurred vision', 'eye strain']
Atherosclerosis --> ['poor wound healing', 'erectile dysfunction (impotence)', 'stroke', 'heart attack', 'mini strokes (transient ischaemic attacks)']
Athlete's foot --> ['itching', 'swelling', 'infection', 'stinging sensation', 'rashes', 'peeling', 'dryness', 'fissures', 'stinging']
Atopic eczema --> ['itching', 'redness', 'rashes', 'peeling', 'dryness', 'flakiness', 'fissures', 'bumps']
Atrial fibrillation --> ['shortness of breath', 'fatigue', 'dizziness', 'inability to exercise', 'weakness', 'chest pain', 'palpitations', 'fast heart rate']
Atrial flutter --> ['shortness of breath', 'dizziness', 'light headedness', 'palpitations', 'fast heart rate', 'irregular heart rate']
Atrial septal defect --> ['fatigue', 'failure to thrive', 'stroke', 'shortness of breath', 'pulmonary hypertension', 'palpitations', 'murmur', 'irregular heart rate']
Attention deficit hyperactivity disorder (ADHD) --> ['depression', 'learning disability', 'anxiety', 'mood swings', 'anger', 'boredom', 'excitement', 'irritability', 'impulsivity']
Autism --> ['anxiety', 'sensitivity to sound', 'change in voice', 'tic', 'impulsivity', 'compulsive behaviour', 'self harm', 'persistent repetition of words', 'actions']
Avascular necrosis --> ['joint stiffness', 'limping', 'collapse', 'hip pain', 'knee pain', 'buttocks pain', 'groin pain', 'thigh pain']
Bacterial vaginosis --> ['vaginal burning', 'abnormal vaginal discharge', 'vaginal itching', 'vaginal odour']
Balanitis --> ['itching', 'swelling', 'tenderness', 'redness', 'discharge from penis']
Barrett's esophagus --> ['throat irritation', 'chronic cough', 'hoarseness', 'indigestion', 'heartburn', 'regurgitation']
Bed sore --> ['swelling', 'chronic wound', 'redness', 'dark scab', 'ulcer of ankle', 'ulcer of coccyx', 'ulcer of heel and mid foot', 'ulcer of hip']
Bedbugs --> ['itching', 'swelling', 'redness', 'small bump']
Bee and wasp stings --> ['itching', 'swelling', 'redness', 'rashes']
Bell's palsy --> ['drooling', 'dry eyes', 'facial muscle weakness', 'ear pain']
Benign prostate enlargement --> ['sexual dysfunction', 'incontinence']
Bipolar disorder --> ['fatigue', 'rapid and frenzied speaking', 'anxiety', 'mood swings', 'general discontent', 'anger', 'guilt', 'loss of interest']
Blepharitis --> ['crusty eyelashes', 'peeling skin', 'eyes pain', 'blurred vision', 'sensitivity to light', 'puffy eyes', 'watery eyes', 'itchiness', 'dryness']
Blindness --> ['blurred vision', 'vision loss']
Body dysmorphic disorder (BDD) --> ['depression', 'unwanted thoughts', 'compulsive behaviour', 'anxiety', 'general discontent']
Bone fracture --> ['swelling', 'tenderness', 'physical deformity', 'bruising', 'bleeding', 'limping', 'loss of height', 'bones pain']
Bone tumor --> ['weight loss', 'swelling', 'limping', 'bone fracture', 'feeling tired', 'joints pain', 'bones pain']
Borderline personality disorder --> ['thoughts of suicide', 'anxiety', 'mood swings', 'general discontent', 'anger', 'guilt', 'loneliness', 'sadness', 'irritability']
Brain aneurysm --> ['headache', 'bleeding', 'stiff neck', 'dizziness', 'light sensitivity', 'thunderclap headache', 'nausea', 'vomiting']
Brain tumours --> ['seizures', 'blurred vision', 'sleepiness', 'difficulty speaking', 'personality change', 'fatigue', 'dizziness', 'vertigo', 'nausea']
Breast cancer --> ['swollen lymph nodes', 'redness', 'thickening', 'puckering of the skin']
Bronchiectasis --> ['weight loss', 'phlegm', 'deformity of nails', 'recurrent infection', 'fatigue', 'inability to exercise', 'chest pain', 'shortness of breath', 'wheezing']
Bronchiolitis --> ['coughing', 'nasal congestion', 'fever', 'loss of appetite', 'malaise', 'dehydration', 'shortness of breath', 'fast breathing', 'wheezing']
Bulimia --> ['depression', 'sore throat', 'abnormality of taste', 'poor self esteem', 'fatigue', 'dehydration', 'water electrolyte imbalance', 'hunger', 'food aversion']
Burn --> ['swelling', 'tenderness', 'sensitivity to pain', 'sweating', 'flushing', 'redness', 'blister', 'peeling', 'total loss of colour']
C. Diff. Colitis --> ['fever', 'bloating', 'diarrhoea', 'blood in stool', 'abdomen pain']
Canker sore --> ['mouth ulcer', 'mouth pain']
Cardiac arrest --> ['shortness of breath', 'palpitations', 'pulselessness', 'light headedness', 'fainting', 'collapse', 'chest pain']
Cardiomyopathy --> ['shortness of breath', 'coughing', 'weight gain', 'swelling in extremities', 'fatigue', 'loss of appetite', 'dizziness', 'bloating', 'fluid in the abdomen']
Carpal tunnel syndrome --> ['sensation of pins and needles', 'hand numbness', 'hand clumsiness', 'hand pain at night', 'hand weakness', 'wrist weakness', 'hands pain', 'wrist pain', 'forearm pain']
Cat scratch fever --> ['swollen lymph nodes', 'small bump on skin', 'fatigue', 'fever', 'joints pain']
Cataracts --> ['blurred vision', 'vision loss', 'inability to see in dim light', 'seeing halos around lights']
Cauliflower ear --> ['swelling', 'physical deformity', 'bruising']
Cavity --> ['toothache', 'tooth loss']
Cellulite --> ['overweight', 'localized accumulation of fat', 'skin dimpling']
Cellulitis --> ['pus', 'fever', 'malaise', 'chills', 'blister', 'red rashes', 'swelling', 'warmness', 'skin pain']
Cerebral palsy --> ['physical deformity', 'difficulty swallowing', 'hearing loss', 'tremor', 'seizures', 'constipation', 'drooling', 'difficulty raising the foot', 'leaking of urine']
Cervical cancer --> ['weight loss', 'fatigue', 'nausea', 'pelvis pain', 'abnormal vaginal discharge', 'abnormal vaginal bleeding', 'irregular menstruation', 'abnormal menstruation', 'heavy menstruation']
Chalazion --> ['lump on the eyelid', 'eyelid redness']
Charcot-Marie-Tooth disorder --> ['tremor', 'slow reflexes', 'hand contractures', 'muscle weakness', 'loss of muscle', 'abnormality walking', 'instability', 'rhythmic muscle contractions', 'flaccid muscles']
Chiari malformation --> ['headache', 'nausea', 'difficulty swallowing', 'rapid involuntary eye movement', 'ringing in the ears', 'impaired voice', 'vertigo', 'neck pain', 'muscle weakness']
Chickenpox --> ['headache', 'itching', 'swollen lymph nodes', 'sore throat', 'fatigue', 'fever', 'loss of appetite', 'blister', 'ulcers']
Chilblains --> ['itching', 'swelling', 'redness', 'rashes', 'blister', 'ulcers']
Childhood obesity --> ['overweight', 'binge eating', 'pot belly', 'shortness of breath']
Chlamydia --> ['eye discharge', 'spotting', 'pelvis pain', 'eyes pain', 'vagina pain', 'testicle pain', 'lower abdomen pain', 'abnormal vaginal discharge', 'vaginal bleeding']
Cholecystitis --> ['yellow skin and eyes', 'abdominal cramping from gallstones', 'fever', 'sweating', 'chills', 'nausea', 'vomiting', 'bloating', 'abdomen pain']
Chronic fatigue syndrome (CFS/ME) --> ['headache', 'depression', 'sore throat', 'muscle weakness', 'sensitivity to pain', 'fatigue', 'malaise', 'inability to exercise', 'joints pain']
Chronic kidney disease --> ['itching', 'swelling', 'failure to thrive', 'insufficient urine production', 'kidney damage', 'severe unintentional weight loss', 'abnormal heart rhythm', 'kidney failure', 'fluid in the lungs']
Chronic lymphocytic leukemia --> ['fatigue', 'swollen lymph nodes']
Chronic myeloid leukemia --> ['weight loss', 'shortness of breath', 'bruising', 'bleeding', 'pallor', 'reduced ability to exercise', 'fatigue', 'malaise', 'anaemia']
Chronic obstructive pulmonary disease --> ['weight loss', 'chest pressure', 'loss of muscle', 'fatigue', 'inability to exercise', 'shortness of breath', 'wheezing', 'frequent respiratory infections']
Chronic pain --> ['headache', 'fatigue', 'anxiety', 'sleep deprivation', 'back pain', 'joints pain', 'neck pain', 'mouth and face pain', 'muscles and bones pain']
Cirrhosis --> ['itching', 'swelling', 'shortness of breath', 'bruising', 'bleeding', 'mental confusion', 'muscle weakness', 'swelling in extremities', 'dark urine']
Cleft lip and cleft palate --> ['physical deformity', 'hearing loss', 'nasal congestion', 'mouth breathing', 'snoring', 'baby feeding difficulties']
Clinical depression --> ['repeatedly going over thoughts', 'poor appetite', 'fatigue', 'loss of appetite', 'excessive hunger', 'anxiety', 'mood swings', 'general discontent', 'guilt']
Club foot --> ['foot deformity', 'abnormality walking', 'callus', 'knock knees', 'shortened legs']
Cluster headaches --> ['headache', 'runny nose', 'agitation', 'sweating', 'flushing', 'nervous system dysfunction', 'redness', 'puffy eyes', 'watery eyes']
Coarctation of the aorta --> ['shortness of breath', 'failure to thrive', 'blue skin from poor circulation', 'diminished pulses', 'low blood pressure', 'high blood pressure', 'murmur', 'enlarged heart']
Coeliac disease --> ['weight loss', 'itching', 'cramping', 'skin rash', 'lactose intolerance', 'fatigue', 'malnutrition', 'bone loss', 'nausea']
Cold sores --> ['burning sensation', 'redness', 'rashes', 'blister', 'ulcers', 'tingling lips', 'sore lip', 'tingling']
Colon cancer --> ['weight loss', 'abdominal discomfort', 'fatigue', 'anaemia', 'constipation', 'blood in stool', 'passing excessive amounts of gas', 'change in bowel habits', 'narrow stools']
Colorectal polyp --> ['blood in stool']
Common cold --> ['headache', 'swollen lymph nodes', 'chest pressure', 'throat irritation', 'fatigue', 'fever', 'malaise', 'chills', 'body ache']
Complex regional pain syndrome --> ['headache', 'swelling', 'depression', 'tenderness', 'stiffness', 'redness', 'sweating', 'nervous system dysfunction', 'back pain']
Concussion --> ['irritability', 'ringing in the ears', 'sensitivity to light', 'mild depression', 'fatigue', 'poor balance', 'blackout', 'nausea', 'vomiting']
Congenital adrenal hyperplasia --> ['irregular menstruation', 'vomiting', 'enlarged clitoris', 'inappropriate male features', 'insufficient amount of cortisol hormones', 'dehydration', 'low blood pressure', 'water electrolyte imbalance', 'low blood sugar']
Conjunctivitis --> ['sensitivity to light', 'eyes pain', 'redness', 'puffy eyes', 'watery eyes', 'itchiness', 'dryness', 'irritation', 'discharge']
Contact dermatitis --> ['itching', 'swelling', 'redness', 'rashes', 'blister', 'peeling', 'ulcers', 'fissures', 'hives']
Corn --> ['dryness', 'thickness']
Coronary heart disease --> ['shortness of breath', 'fast heart rate', 'sweating', 'light headedness', 'nausea', 'indigestion', 'chest pain']
Costochondritis --> ['tenderness', 'chest pain', 'rib pain']
Cradle cap --> ['dandruff', 'white', 'yellow scales on scalp', 'redness', 'rashes', 'dryness', 'flakiness', 'oily skin']
Crohn's disease --> ['weight loss', 'depression', 'cramping', 'flare', 'mouth ulcer', 'slow growth', 'fatigue', 'fever', 'loss of appetite']
Crossed eye --> ['headache', 'eye strain', 'blurred vision', 'double vision']
Croup --> ['sore throat', 'phlegm', 'drooling', 'agitation', 'fatigue', 'fever', 'shortness of breath', 'fast breathing', 'wheezing']
Cystic fibrosis --> ['weight loss', 'infection', 'deformity of nails', 'pneumonia', 'acute bronchitis', 'male infertility', 'nasal polyps', 'salty sweat', 'fatigue']
Cystocele --> ['pelvic pressure', 'vaginal bulge']
De Quervain's tenosynovitis --> ['swelling', 'tenderness', 'difficulty gripping', 'wrist pain']
Deep vein thrombosis --> ['tenderness', 'swelling in extremities', 'warm skin', 'foot pain', 'leg pain', 'calf pain']
Degenerative disc disease --> ['physical deformity', 'stiffness', 'muscle spasms', 'nerve injury', 'neck pain', 'lower back pain', 'legs pain']
Dementia --> ['sleep disorder', 'memory loss', 'falling', 'jumbled speech', 'inability to combine muscle movements', 'unsteady walking', 'anxiety', 'mood swings', 'loneliness']
Dental abscess --> ['swollen lymph nodes', 'pus', 'fever', 'jaw pain', 'bad breath', 'toothache', 'dental cavities', 'tooth loss']
Dermatitis herpetiformis --> ['itching', 'redness', 'rashes', 'blister', 'small bump', 'darkening of the skin']
Diabetic ketoacidosis --> ['weight loss', 'mental confusion', 'blurred vision', 'sleepiness', 'fatigue', 'loss of appetite', 'malaise', 'dehydration', 'excessive thirst']
Diabetic neuropathy --> ['sexual dysfunction', 'slow reflexes', 'skin ulcer', 'foot pain', 'nerves pain']
Diabetic retinopathy --> ['new and abnormal blood vessels', 'blurred vision', 'vision loss', 'distorted vision', 'vision disorder', 'seeing spots', 'impaired colour vision']
Diaper rash --> ['itchiness around anus', 'redness', 'rashes', 'blister', 'peeling', 'pimples']
Dislocated shoulder --> ['swelling', 'physical deformity', 'bruising', 'limited joint mobility', 'shoulder pain']
Dissociative identity disorder --> ['amnesia', 'blackout', 'anxiety', 'mood swings', 'feeling detached from self', 'impulsivity', 'self harm', 'self destructive behaviour', 'depression']
Diverticulosis --> ['constipation', 'change in bowel habits', 'abdomen pain']
Dog attack --> ['swelling', 'redness', 'bruising', 'bleeding', 'infection']
Down syndrome --> ['hearing loss', 'vision disorder', 'mouth breathing', 'single line on palm', 'difficulty thinking and understanding', 'congenital heart disease', 'obesity', 'brachycephaly', 'upslanting palpebral fissures']
Drug allergy --> ['itching', 'swelling', 'nausea', 'fever', 'runny nose', 'watery eyes', 'wheezing', 'rashes', 'hives']
Dry eyes --> ['sensitivity to light', 'eyes pain', 'redness', 'dryness', 'eye discomfort', 'feeling of something in eye']
Duchenne muscular dystrophy --> ['fatigue', 'difficulty swallowing', 'scoliosis', 'constantly walking on tip toe', 'enlarged calves', 'frequent falls', 'muscle weakness', 'loss of muscle', 'abnormality walking']
Dupuytren's contracture --> ['lump in the palm', 'bent finger']
Dyslexia --> ['headache', 'speech impairment', 'delayed reading ability']
Dystonia --> ['eyelid twitching', 'torticollis', 'twisting movements', 'voice box spasms', 'cramping', 'involuntary movements']
Ear infections --> ['headache', 'nausea', 'nasal congestion', 'crying', 'fever', 'loss of appetite', 'vertigo', 'ear pain']
Early menopause --> ['irritability', 'insomnia', 'sexual dysfunction', 'infertility', 'mood swings', 'vaginal dryness', 'fatigue', 'night sweats', 'hot flashes']
Eclampsia --> ['headache', 'swelling', 'seizures', 'swelling in extremities', 'vision disorder', 'fainting', 'pregnancy induced hypertension', 'fetal distress', 'mental status changes']
Ectopic pregnancy --> ['cramping', 'abnormal vaginal bleeding', 'nausea', 'vomiting', 'bloating', 'abdomen pain', 'pelvis pain', 'side part of the body pain']
Ehlers-Danlos syndromes --> ['physical deformity', 'bleeding', 'muscle weakness', 'easy bruising', 'poor wound healing', 'double jointed', 'heart murmur', 'joint dislocation', 'wrinkles']
Encephalitis --> ['headache', 'irritability', 'seizures', 'stiff neck', 'reduced sensation of touch', 'light sensitivity', 'fatigue', 'fever', 'loss of appetite']
Encephalopathy --> ['rapid involuntary eye movement', 'flapping hand tremor', 'personality change', 'coma', 'delirium', 'abnormal breathing pattern', 'seizures with no outward symptoms', 'fatigue', 'fainting']
Endocarditis --> ['heart murmur', 'fatigue', 'fever', 'malaise', 'chills', 'night sweats']
Endometriosis --> ['infertility', 'nausea', 'constipation', 'pelvis pain', 'lower back pain', 'vagina pain', 'rectum pain', 'lower abdomen pain', 'irregular menstruation']
Epilepsy --> ['depression', 'anxiety', 'seizures', 'amnesia', 'staring spells', 'fatigue', 'fainting', 'muscle spasms', 'rhythmic muscle contractions']
Erectile dysfunction (impotence) --> ['anxiety', 'soft erections', 'trouble getting an erection', 'trouble maintaining an erection']
Erythema nodosum --> ['red', 'flat', 'firm', 'hot', 'and painful lumps', 'inflammatory nodules of the leg', 'fever', 'malaise', 'joints pain']
Esophageal cancer --> ['weight loss', 'difficulty swallowing', 'loss of appetite', 'iron deficiency anaemia', 'nausea', 'indigestion', 'heartburn', 'dark stool from digested blood', 'vomiting blood']
Esophageal varices --> ['bleeding', 'difficulty swallowing', 'flapping hand tremor', 'enlarged veins around belly button', 'bloating', 'blood in stool', 'dark stool from digested blood', 'vomiting blood']
Esophagitis --> ['coughing', 'nausea', 'vomiting', 'heartburn', 'belching', 'regurgitation', 'chest pain', 'upper abdomen pain']
Eye injury --> ['swelling', 'bleeding', 'black eye', 'eyes pain', 'vision loss', 'vision disorder', 'redness', 'dilated pupil']
Eye web --> ['blurred vision', 'redness', 'irritation', 'eye discomfort', 'growth in the eye']
Farsighted --> ['headache', 'blurred vision', 'distorted vision', 'vision disorder', 'eye strain', 'squinting']
Fetal alcohol syndrome --> ['anxiety', 'hearing loss', 'vision disorder', 'speech impairment', 'single line on palm', 'intellectual disability', 'congenital heart disease', 'misshapen face', 'malnutrition']
Fibrocystic breast disease --> ['swelling', 'change in breast texture']
Fibroids --> ['cramping', 'abdominal distension', 'abdomen pain', 'pelvis pain', 'lower back pain', 'irregular menstruation', 'abnormal menstruation', 'heavy menstruation', 'spotting']
Fibromyalgia --> ['headache', 'depression', 'irritability', 'joint stiffness', 'flare', 'sensitivity to cold', 'tingling feet', 'painful menstruation', 'fatigue']
Flat feet --> ['foot pain']
Flu --> ['headache', 'shortness of breath', 'swollen lymph nodes', 'nausea', 'sore throat', 'chest pressure', 'head congestion', 'fatigue', 'fever']
Folliculitis --> ['itching', 'swelling', 'pus', 'redness', 'rashes', 'blister', 'pimples', 'stinging']
Fragile X syndrome --> ['anxiety', 'tremor', 'sleep disorder', 'scoliosis', 'speech impairment', 'single line on palm', 'double jointed', 'lazy eye', 'enlarged head']
Frostbite --> ['blistering', 'feeling cold', 'waxy skin', 'redness', 'blue skin from poor circulation', 'stinging']
Frozen shoulder --> ['joint stiffness', 'decreased range of shoulder motion', 'shoulder pain']
Fungal infection --> ['itching', 'vaginal discharge', 'deformed toenail', 'rashes', 'peeling', 'small bump', 'darkening of the skin', 'loss of colour']
G6PD deficiency --> ['pallor', 'yellow skin and eyes', 'dark urine', 'fatigue', 'anaemia', 'abdomen pain', 'back pain']
Gallstones --> ['nausea', 'vomiting', 'indigestion', 'back pain', 'upper right abdomen pain']
Ganglion cyst --> ['pain in the affected area', 'lump', 'wrist pain']
Gangrene --> ['pus', 'reduced sensation of touch', 'creaky joints', 'foul smelling discharge', 'fever', 'low blood pressure', 'blister', 'ulcers', 'blue skin from poor circulation']
Gastritis --> ['loss of appetite', 'nausea', 'vomiting', 'indigestion', 'heartburn', 'belching', 'abdomen pain', 'upper abdomen pain']
Gastroparesis --> ['postprandial fullness', 'loss of appetite', 'feeling full sooner than normal', 'nausea', 'vomiting', 'bloating', 'indigestion', 'heartburn', 'belching']
Generalised anxiety disorder in adults --> ['headache', 'nausea', 'palpitations', 'repeatedly going over thoughts', 'trembling', 'excessive worry', 'difficulty falling asleep', 'emotional distress', 'fatigue']
Genital herpes --> ['sensation of pins and needles', 'skin rash', 'genital sores', 'vagina pain', 'penis pain']
Genital warts --> ['itching', 'warts and verrucas', 'itchiness around anus', 'itching of vagina', 'skin burning sensation']
Gestational diabetes --> ['frequent urination', 'fetal macrosomia', 'thrush in men and women', 'fatigue', 'excessive hunger', 'excessive thirst']
Giardiasis --> ['weight loss', 'cramping', 'foul smelling stool', 'fatigue', 'loss of appetite', 'malaise', 'malnutrition', 'nausea', 'bloating']
Gilbert's syndrome --> ['yellow skin and eyes']
Glandular fever --> ['headache', 'swollen lymph nodes', 'nausea', 'sore throat', 'swollen tonsils', 'fatigue', 'fever', 'malaise', 'chills']
Glaucoma --> ['blurred vision', 'vision loss', 'distorted vision']
Goiter --> ['shortness of breath', 'fast heart rate', 'coughing', 'weight gain', 'underactive thyroid', 'inability to tolerate heat', 'throat tightness']
Gonorrhoea --> ['sore throat', 'pus', 'fever', 'irregular menstruation', 'frequent urge to urinate', 'pelvis pain', 'vagina pain', 'testicle pain', 'lower abdomen pain']
Gout --> ['physical deformity', 'redness', 'joints pain', 'foot pain', 'knee pain', 'ankle pain', 'toe pain']
Granulomatosis with polyangiitis --> ['hearing loss', 'mouth ulcer', 'blood in urine', 'kidney failure', 'unintentional weight loss', 'fatigue', 'fever', 'joints pain', 'shortness of breath']
Graves' disease --> ['weight loss', 'irritability', 'muscle weakness', 'insomnia', 'absence of menstruation', 'hair loss', 'enlarged thyroid', 'diarrhoea', 'hand tremor']
Groin hernia --> ['swollen lymph nodes in the groin', 'pelvis pain', 'testicle pain', 'groin pain']
Group B streptococcal infection --> ['skin rash', 'pneumonia', 'vaginal discharge', 'low birth weight', 'urinary tract infections (utis)', 'fever', 'lethargy', 'skin pain']
Gum disease --> ['swelling', 'bleeding', 'bad breath', 'toothache', 'tooth loss', 'bright red gums', 'loose teeth', 'receding gums', 'tender gums']
Gynecomastia --> ['overweight']
HIV/AIDS --> ['headache', 'swollen lymph nodes', 'skin rash', 'severe unintentional weight loss', 'pneumonia', 'opportunistic infection', 'oral thrush (mouth thrush)', 'red blotches', 'fatigue']
Haemophilia --> ['bruising', 'bleeding', 'blood in urine', 'nosebleed', 'blood in stool', 'heavy', 'prolonged periods', 'internal bleeding', 'swollen joint']
Hand, foot and mouth disease --> ['headache', 'irritability', 'coughing', 'sore throat', 'canker sore', 'fatigue', 'fever', 'loss of appetite', 'malaise']
Hashimoto's disease --> ['depression', 'fatigue', 'joint stiffness', 'weight gain', 'muscle weakness', 'swelling in extremities', 'constipation', 'sensitivity to cold', 'enlarged thyroid']
Head and neck cancer --> ['mouth ulcer', 'enlarged neck lymph nodes', 'hoarseness', 'ear pain']
Head lice and nits --> ['itching', 'skin bumps']
Hearing loss --> ['social isolation', 'hearing problem', 'ringing in the ears', 'sensitivity to sound', 'speech delay in a child']
Heart attack --> ['shortness of breath', 'anxiety', 'chest pressure', 'palpitations', 'feeling of impending doom', 'shoulder discomfort', 'fatigue', 'dizziness', 'sweating']
Heart failure --> ['weight gain', 'palpitations', 'swollen legs', 'excess urination at night', 'swollen feet', 'fatigue', 'loss of appetite', 'dizziness', 'inability to exercise']
Heat rash (prickly heat) --> ['itching', 'flushing', 'rashes', 'blister', 'red rashes', 'bumps']
Hemangioma --> ['bleeding', 'birthmark']
Hemorrhagic stroke --> ['headache', 'bleeding', 'seizures', 'sensitivity to light', 'difficulty speaking', 'fainting', 'altered level of consciousness', 'decreased level of consciousness', 'ekg abnormalities']
Henoch-Schönlein purpura --> ['fever', 'blood in urine', 'rash of small purplish spots', 'vomiting', 'diarrhoea', 'blood in stool', 'abdomen pain', 'joints pain']
Hepatitis A --> ['weight loss', 'itching', 'yellow skin and eyes', 'dark urine', 'fatigue', 'fever', 'loss of appetite', 'nausea', 'vomiting']
Hepatitis B --> ['fluid in the abdomen', 'fatigue', 'malaise', 'yellow skin and eyes']
Hepatitis C --> ['weight loss', 'depression', 'fatigue', 'fever', 'loss of appetite', 'nausea', 'bloating', 'fluid in the abdomen', 'bleeding']
Hepatitis E --> ['yellow skin and eyes', 'dark urine', 'fatigue', 'fever', 'loss of appetite', 'nausea', 'vomiting', 'pale faeces', 'abdomen pain']
Hepatocellular carcinoma --> ['weight loss', 'yellow skin and eyes', 'loss of appetite', 'liver failure', 'bloating', 'fluid in the abdomen', 'abdomen pain']
Hernia --> ['tenderness', 'abdominal discomfort', 'abdominal distension', 'groin discomfort', 'abdomen pain', 'pelvis pain', 'testicle pain']
Herpangina --> ['headache', 'irritability', 'fever', 'loss of appetite', 'malaise', 'nausea', 'vomiting', 'ulcers', 'drooling']
Hiatus hernia --> ['throat irritation', 'nausea', 'vomiting', 'heartburn', 'belching', 'regurgitation', 'hiccup', 'abdomen pain', 'chest pain']
Hidradenitis suppurativa --> ['itching', 'swelling', 'pus', 'abscess', 'pimple', 'blackhead', 'body odour', 'excess sweating', 'rashes']
High cholesterol --> ['heart attack', 'peripheral artery disease', 'stroke']
Hip dislocation --> ['swelling', 'physical deformity', 'bruising', 'joints pain', 'muscle weakness', 'abnormality walking', 'permanent shortening of muscle']
Hip fracture --> ['swelling', 'bruising', 'abnormality walking', 'visible deformity of lower extremity', 'hip pain', 'groin pain']
Hirschsprung's disease --> ['failure to thrive', 'vomiting', 'bloating', 'constipation', 'flatulence', 'leaking of stool', 'newborn unable to pass first stool']
Hives --> ['itching', 'swelling', 'flare', 'raised area of skin', 'inflammation in response to touch']
Hodgkin's lymphoma --> ['weight loss', 'itching', 'swollen lymph nodes', 'night sweats', 'fatigue', 'fever', 'loss of appetite']
Horner's syndrome --> ['blurred vision', 'nerve injury', 'inability to sweat normally', 'drooping of upper eyelid', 'unequal pupils']
Human papillomavirus (HPV) --> ['itching', 'warts and verrucas']
Huntington's disease --> ['weight loss', 'tremor', 'memory loss', 'difficulty speaking', 'problems with coordination', 'muscle spasms', 'loss of muscle', 'abnormality walking', 'involuntary movements']
Hydrocele --> ['swollen testicle', 'testicular discomfort']
Hydrocephalus --> ['headache', 'irritability', 'mental confusion', 'blurred vision', 'sleepiness', 'leaking of urine', "bulging soft spot on a baby's head", 'delayed development', 'enlargement of head']
Hydronephrosis --> ['high blood pressure', 'abdomen pain', 'flank pain']
Hypercalcemia --> ['weight loss', 'mental confusion', 'muscle weakness', 'excess urination', 'fatigue', 'loss of appetite', 'dehydration', 'thirst', 'nausea']
Hyperdontia --> ['toothache', 'crowded teeth', 'misaligned teeth']
Hyperthyroidism --> ['weight loss', 'muscle weakness', 'tremor', 'hair loss', 'diarrhoea', 'warm skin', 'fatigue', 'excessive hunger', 'excess sweating']
Hypertrophic cardiomyopathy --> ['shortness of breath', 'fatigue', 'dizziness', 'inability to exercise', 'chest pain', 'palpitations', 'murmur', 'enlarged heart']
Hypogonadism --> ['depression', 'irritability', 'weight gain', 'absence of menstruation', 'infertility', 'mood swings', 'pot belly', 'delayed puberty', 'fatigue']
Hyponatremia --> ['headache', 'nausea', 'mental confusion', 'insufficient urine production', 'fatigue', 'malaise', 'dizziness', 'lethargy', 'thirst']
Ichthyosis --> ['itching', 'hyperlinearity of palms and soles', 'thickened skin on palms and soles', 'peeling', 'dryness', 'flakiness', 'fissures', 'skin pain']
Idiopathic intracranial hypertension --> ['headache', 'ringing in the ears', 'dizziness', 'nausea', 'vomiting', 'blurred vision', 'double vision', 'partial loss of vision']
Idiopathic thrombocytopenic purpura --> ['bruising', 'bleeding', 'nosebleed', 'heavy', 'prolonged periods', 'red spots', 'rash of small purplish spots']
Iliotibial band syndrome --> ['swelling', 'hip pain', 'knee pain', 'leg pain']
Impetigo --> ['itching', 'blister', 'red rashes']
Infant respiratory distress syndrome --> ['insufficient urine production', 'blue skin from poor circulation', 'low birth weight', 'respiratory distress syndrome', 'shortness of breath', 'fast breathing', 'episodes of no breathing']
Infertility --> ['anxiety', 'inability to get pregnant']
Inflammatory breast cancer --> ['swelling', 'swollen lymph nodes', 'redness', 'rashes', 'dimpled skin like an orange peel']
Ingrown toenail --> ['swelling', 'redness', 'tenderness', 'limping']
Insect bites and stings --> ['itching', 'swelling', 'stinging sensation', 'redness', 'rashes']
Insomnia --> ['headache', 'depression', 'irritability', 'sleeping difficulty']
Insulin resistance --> ['obesity', 'absence of menstruation', 'excessive hairiness', 'lipodystrophy', 'skin tags']
Interstitial cystitis --> ['pelvis pain', 'testicle pain', 'penis pain', 'bladder pain']
Interstitial lung disease --> ['weight loss', 'deformity of nails', 'fatigue', 'inability to exercise', 'shortness of breath', 'fast breathing']
Intrauterine growth restriction --> ['low birth weight']
Iron deficiency --> ['shortness of breath', 'pallor', 'brittle nails', 'fatigue', 'dizziness', 'light headedness', 'palpitations', 'fast heart rate']
Iron deficiency anaemia --> ['headache', 'shortness of breath', 'irritability', 'brittle nails', 'hair loss', 'restless legs syndrome', 'fatigue', 'malaise', 'dizziness']
Iron overload --> ['erectile dysfunction (impotence)', 'abnormal heart rhythm', 'diabetes', 'hepatitis', 'fatigue', 'lethargy', 'reduced hormone production', 'abdomen pain']
Irritable bowel syndrome (IBS) --> ['depression', 'anxiety', 'loss of appetite', 'discomfort', 'symptoms alleviated by defecation', 'nausea', 'diarrhoea', 'indigestion', 'constipation']
Jet lag --> ['headache', 'irritability', 'lack of concentration', 'indigestion', 'fatigue', 'malaise']
Jock itch --> ['itching', 'redness', 'groin rash']
Keratitis --> ['eyes pain', 'blurred vision', 'sensitivity to light', 'vision disorder', 'redness', 'watery eyes', 'feeling of something in eye']
Keratoconus --> ['blurred vision', 'vision loss', 'sensitivity to light', 'double vision', 'distorted vision', 'inability to see in dim light', 'nearsightedness', 'astigmatism']
Keratosis pilaris --> ['follicular papules', 'redness', 'dryness', 'darkening of the skin', 'pimples']
Kidney infection --> ['fast heart rate', 'fatigue', 'fever', 'loss of appetite', 'malaise', 'chills', 'nausea', 'vomiting', 'back pain']
Kidney stone --> ['sweating', 'nausea', 'vomiting', 'back pain', 'side part of the body pain']
Klinefelter syndrome --> ['breast enlargement in men', 'delayed puberty', 'flaccid muscles', 'infertility', 'low set ears', 'osteoporosis', 'reduced sex drive', 'small penis', 'adhd predominantly inattentive']
Kyphosis --> ['physical deformity', 'stiffness', 'falling', 'compression fracture', 'short stature', 'mobility disability', 'back pain', 'neck pain', 'muscle weakness']
Labyrinthitis --> ['hearing loss', 'rapid involuntary eye movement', 'dizziness', 'nausea', 'vomiting']
Lactose intolerance --> ['baby colic', 'malaise', 'bloating', 'diarrhoea', 'indigestion', 'belching', 'flatulence', 'fat in stool', 'stomach cramps']
Laryngitis --> ['swollen lymph nodes', 'phlegm', 'sleeping difficulty', 'fever', 'malaise']
Latex allergy --> ['itching', 'throat irritation', 'watery eyes', 'redness', 'rashes', 'blister']
Lazy eye --> ['eye misalignment', 'blurred vision', 'double vision']
Lead poisoning --> ['headache', 'insomnia', 'memory loss', 'baby colic', 'fatigue', 'loss of appetite', 'nausea', 'vomiting', 'constipation']
Leukemia --> ['shortness of breath', 'swollen lymph nodes', 'bleeding', 'pallor', 'weakness', 'mouth ulcer', 'nosebleed', 'red spots on skin', 'easy bruising']
Leukoplakia --> ['redness', 'mouth lesion']
Lichen planus --> ['itching', 'mouth ulcer', 'hair loss', 'redness', 'rashes', 'blister', 'peeling', 'ulcers', 'small bump']
Lichen sclerosus --> ['itching', 'bruising', 'skin tears', 'vulval itch', 'redness', 'rashes', 'loss of colour']
Liver cancer --> ['weight loss', 'itching', 'yellow skin and eyes', 'fatigue', 'loss of appetite', 'cancer related fatigue', 'nausea', 'vomiting', 'bloating']
Liver failure --> ['itching', 'swelling', 'bruising', 'bleeding', 'mental confusion', 'yellow skin and eyes', 'flapping hand tremor', 'bad breath from liver disease', 'fatigue']
Long QT syndrome --> ['seizures', 'dizziness', 'fainting', 'feeling faint', 'palpitations', 'abnormal heart rhythm', 'cardiac arrest']
Lordosis --> ['physical deformity', 'large inward arch in the lower back', 'back pain']
Low back pain --> ['muscle spasms', 'back joint dysfunction', 'back pain', 'hip pain', 'leg pain', 'muscles and bones pain']
Low blood sugar (hypoglycaemia) --> ['headache', 'irritability', 'pallor', 'anxiety', 'sensation of pins and needles', 'tremor', 'blurred vision', 'palpitations', 'sleepiness']
Lumbar spinal stenosis --> ['stiffness', 'lower back pain', 'leg pain', 'legs pain', 'back and leg pain', 'muscle weakness', 'cramping']
Lung cancer --> ['weight loss', 'swollen lymph nodes', 'weakness', 'hoarseness', 'fatigue', 'loss of appetite', 'chest pain', 'rib pain', 'shortness of breath']
Lupus --> ['headache', 'weight loss', 'swelling', 'anxiety', 'joint stiffness', 'flare', 'sensitivity to light', 'blood in urine', 'water retention']
Lymphedema --> ['swollen lymph nodes', 'swelling in extremities', 'water retention', 'frequent skin infections of affected limb', 'rashes', 'dimpled skin like an orange peel', 'skin pain', 'legs pain', 'arms pain']
Macular degeneration --> ['new and abnormal blood vessels', 'blurred vision', 'distorted vision', 'inability to see in dim light', 'seeing spots', 'partial loss of vision', 'abnormality where straight lines appear wavy']
Malabsorption --> ['weight loss', 'cramping', 'bloating', 'diarrhoea', 'flatulence', 'fat in stool', 'abdomen pain']
Malaria --> ['headache', 'fast heart rate', 'pallor', 'mental confusion', 'fatigue', 'fever', 'sweating', 'chills', 'night sweats']
Male or Female pattern baldness --> ['hair loss']
Malnutrition --> ['weight loss', 'fatigue', 'dizziness', 'water electrolyte imbalance', 'muscle weakness', 'loss of muscle']
Marfan syndrome --> ['fatigue', 'scoliosis', 'double jointed', 'flat feet', 'small pupils', 'abnormally long fingers', 'collapsed lung', 'disproportionately long arms and legs', 'stretch marks']
Mastoiditis --> ['headache', 'swelling', 'tenderness', 'pus', 'redness', 'fever', 'ear pain']
Melasma --> ['darkening of the skin']
Meningitis --> ['headache', 'irritability', 'fast heart rate', 'mental confusion', 'sleepiness', 'stiff neck', 'light sensitivity', 'fear of loud sounds']
Menopause --> ['irritability', 'anxiety', 'dry skin', 'reduced sex drive', 'vaginal dryness', 'moodiness', 'fatigue', 'sweating', 'night sweats']
Metabolic syndrome --> ['high blood pressure', 'pot belly', 'diabetes', 'obesity', 'overweight']
Microcephaly --> ['hearing loss', 'vision disorder', 'speech impairment', 'intellectual disability', 'misshapen face', 'malnutrition', 'poor coordination', 'irritability', 'impulsivity']
Migraine --> ['irritability', 'nasal congestion', 'scalp tenderness', 'malaise', 'dizziness', 'light headedness', 'nausea', 'vomiting', 'neck pain']
Misaligned teeth --> ['physical deformity', 'misaligned teeth', 'jaw pain']
Miscarriage --> ['fatigue', 'cramping', 'irregular uterine bleeding', 'nausea', 'vomiting', 'abdomen pain', 'pelvis pain', 'lower back pain', 'vaginal discharge']
Misophonia --> ['aggression', 'irritation', 'anxiety', 'anger', 'depression', 'fear of loud sounds']
Mitral valve prolapse --> ['shortness of breath', 'chest pressure', 'regurgitation', 'palpitations', 'murmur', 'irregular heart rate', 'abnormal heart rhythm']
Molar pregnancy --> ['fast heart rate', 'absence of menstruation', 'high blood pressure', 'vaginal bleeding', 'nausea', 'vomiting', 'abdomen pain']
Molluscum contagiosum --> ['redness', 'small bump', 'lumps']
Morton's neuroma --> ['lump in the sole of the foot', 'sensation of walking on a marble', 'foot pain']
Motion sickness --> ['headache', 'pallor', 'palpitations', 'malaise', 'dizziness', 'balance disorder', 'nausea', 'vomiting', 'belching']
Multiple myeloma --> ['weight loss', 'constipation', 'kidney damage', 'hypercalcemia', 'increased risk of infection', 'fatigue', 'loss of appetite', 'anaemia', 'back pain']
Multiple sclerosis --> ['headache', 'depression', 'difficulty swallowing', 'constipation', 'weakness', 'flare', 'rapid involuntary eye movement', 'sleep deprivation', 'difficulty raising the foot']
Muscular dystrophy --> ['fatigue', 'difficulty swallowing', 'constipation', 'scoliosis', 'constantly walking on tip toe', 'shallow breathing', 'cardiomyopathy', 'muscles pain', 'muscle weakness']
Myasthenia gravis --> ['shortness of breath', 'fatigue', 'difficulty swallowing', 'difficulty speaking', 'double vision', 'muscle weakness', 'weakness of the arms and legs']
Myelodysplastic syndrome --> ['bruising', 'bleeding', 'pallor', 'infection', 'red spots on skin', 'shortness of breath on exercise', 'fatigue', 'malaise', 'anaemia']
Myocarditis --> ['swelling in extremities', 'fatigue', 'malaise', 'dizziness', 'chest pain', 'shortness of breath', 'fast breathing', 'shortness of breath on lying down', 'palpitations']
Ménière's disease --> ['nausea', 'hearing loss', 'rapid involuntary eye movement', 'imbalance', 'motion sickness', 'dizziness', 'vertigo']
Narcissistic personality disorder --> ['social isolation', 'grandiosity', 'callous and unemotional traits', "disregard for others' feelings", 'excessive need for admiration']
Narcolepsy --> ['fatigue', 'hallucination', 'muscle weakness', 'muscle paralysis', 'loss of muscle control']
Nasal polyps --> ['headache', 'snoring', 'abnormality of taste', 'face pain', 'sinusitis', 'breathing through the mouth']
Nasal septum deviation --> ['headache', 'physical deformity', 'mouth breathing', 'snoring', 'sinuses pain']
Nearsighted --> ['headache', 'blurred vision', 'distorted vision', 'eye strain', 'squinting']
Neuroendocrine tumor --> ['flushing', 'low blood sugar']
Neurofibromatosis --> ['sensation of pins and needles', 'hearing loss', 'seizures', 'vision disorder', 'ringing in the ears', 'scoliosis', 'enlarged head', 'bone deformities', 'attention deficit hyperactivity disorder (adhd)']
Neutropenia --> ['sore throat', 'fever', 'mouth ulcer', 'susceptibility to infection']
Non-Hodgkin lymphoma --> ['weight loss', 'swollen lymph nodes', 'night sweats', 'b symptoms', 'fatigue', 'loss of appetite', 'anaemia', 'abdomen pain']
Non-alcoholic fatty liver disease (NAFLD) --> ['fatigue']
Nummular dermatitis --> ['itching', 'lesion', 'redness', 'rashes', 'dryness', 'darkening of the skin', 'flakiness', 'coin shaped rashes']
Obesity --> ['fatigue', 'snoring', 'pot belly', 'overweight', 'binge eating', 'back pain', 'joints pain']
Obsessive compulsive disorder (OCD) --> ['nightmares', 'repeatedly going over thoughts', 'food aversion', 'anxiety', 'guilt', 'apprehension', 'panic attack', 'impulsivity', 'social isolation']
Opioid addiction and dependence --> ['nausea', 'reduced sex drive', 'physical substance dependence', 'slurred speech', 'sensitivity to pain', 'small pupils', 'shallow breathing', 'chronic constipation', 'sweating']
Oppositional defiant disorder --> ['depression', 'problem paying attention', 'anxiety', 'anger', 'irritability', 'impulsivity', 'aggression', 'self harm', 'antisocial behaviour']
Optic neuritis --> ['headache', 'eyes pain', 'blurred vision', 'vision loss', 'vision disorder', 'partial loss of vision', 'inability to distinguish certain colours']
Oral cancer --> ['coughing', 'enlarged neck lymph nodes', 'ear pain', 'mouth pain', 'mouth and face pain', 'bad breath', 'ulcers', 'red and white plaques']
Oral thrush (mouth thrush) --> ['difficulty swallowing', 'redness', 'abnormality of taste', 'bad breath', 'dryness', 'white tongue', 'burning mouth syndrome']
Osgood-Schlatter disease --> ['limping', 'lump below knee', 'knee pain', 'leg below the knee pain']
Osteoarthritis --> ['limping', 'joint deformity', 'joints pain', 'neck pain', 'hip pain', 'lower back pain', 'knee pain', 'hands pain']
Osteoporosis --> ['bone fracture', 'loss of height']
Ovarian cancer --> ['weight loss', 'loss of appetite', 'cancer related fatigue', 'nausea', 'bloating', 'indigestion', 'change in bowel habits', 'abdomen pain', 'pelvis pain']
Ovarian cyst --> ['cramping', 'excessive hairiness', 'back pain', 'pelvis pain', 'side part of the body pain', 'irregular menstruation', 'abnormal menstruation', 'spotting', 'painful menstruation']
PMS (premenstrual syndrome) --> ['headache', 'depression', 'irritability', 'weight gain', 'insomnia', 'lack of concentration', 'painful menstruation', 'moodiness', 'acne']
Paget's disease of bone --> ['headache', 'joint stiffness', 'sensation of pins and needles', 'bone fracture', 'abnormality walking', 'bone deformities', 'bow legs', 'back pain', 'joints pain']
Pancreatic cancer --> ['weight loss', 'yellow skin and eyes', 'dark urine', 'fatigue', 'loss of appetite', 'nausea', 'fluid in the abdomen', 'abdomen pain', 'middle back pain']
Pancreatitis --> ['weight loss', 'fast heart rate', 'loss of appetite', 'sweating', 'nausea', 'vomiting', 'bloating', 'indigestion', 'fat in stool']
Parkinson's disease --> ['weight loss', 'depression', 'difficulty swallowing', 'constipation', 'drooling', 'trembling', 'falling', 'blank stare', 'fear of falling']
Patellofemoral pain syndrome --> ['stiffness', 'knee pain', 'muscle weakness', 'abnormality walking']
Pectus excavatum --> ['shortness of breath', 'physical deformity', 'coughing', 'palpitations', 'fatigue', 'inability to exercise', 'chest pain']
Pelvic inflammatory disease --> ['cramping', 'painful menstruation', 'fatigue', 'fever', 'chills', 'nausea', 'vomiting', 'abdomen pain', 'pelvis pain']
Perforated eardrum --> ['pus', 'hearing loss', 'ringing in the ears', 'drainage', 'dizziness', 'vertigo', 'ear pain']
Pericarditis --> ['shortness of breath', 'chest pressure', 'fatigue', 'fever', 'chest pain']
Peripheral artery disease --> ['ulcers', 'cool skin', 'loss of hair on the legs', 'thinning of skin on the legs', 'buttocks pain']
Peripheral neuropathy --> ['weakness', 'tingling feet', 'slow reflexes', 'poor balance', 'tingling fingers', 'back pain', 'foot pain', 'face pain', 'hands pain']
Peritonitis --> ['organ dysfunction', 'fever', 'loss of appetite', 'chills', 'nausea', 'vomiting', 'bloating', 'abdomen pain']
Peritonsillar abscess --> ['swelling', 'swollen lymph nodes', 'pus', 'abscess', 'deviated uvula', 'muffled voice', 'fever', 'malaise', 'chills']
Pernicious anemia --> ['weight loss', 'shortness of breath', 'pallor', 'sensation of pins and needles', 'inflamed stomach', 'fatigue', 'light headedness']
Persistent depressive disorder --> ['irritability', 'indecisiveness', 'low self esteem', 'fatigue', 'loss of appetite', 'excessive hunger', 'general discontent', 'anger', 'guilt']
Peyronie's disease --> ['physical deformity', 'penis shortening', 'penis pain']
Piles (haemorrhoids) --> ['constipation', 'rectum pain']
Pilonidal sinus --> ['tenderness', 'pus', 'abscess', 'redness', 'lumps', 'swelling']
Piriformis syndrome --> ['sensation of pins and needles', 'buttocks pain', 'back and leg pain']
Pityriasis rosea --> ['itching', 'red', 'scaly rash in patches', 'redness', 'rashes', 'small bump', 'loss of colour']
Pityriasis versicolor --> ['redness', 'rashes', 'darkening of the skin', 'loss of colour']
Placenta previa --> ['vaginal bleeding']
Plagiocephaly --> ['physical deformity']
Plantar fasciitis --> ['swelling', 'tenderness', 'limping', 'foot sole pain', 'foot pain', 'heel pain']
Pleurisy --> ['fever', 'dry cough', 'side part of the body pain', 'shortness of breath', 'fast breathing', 'shallow breathing']
Pneumonia --> ['fast heart rate', 'coughing', 'fatigue', 'fever', 'loss of appetite', 'malaise', 'sweating', 'chills', 'dehydration']
Pneumothorax --> ['fast heart rate', 'coughing', 'chest pressure', 'low oxygen in the body', 'chest pain', 'shortness of breath', 'fast breathing', 'shallow breathing']
Polycystic kidney disease --> ['blood in urine', 'kidney damage', 'lump in the abdomen', 'high blood pressure', 'fatigue syndrome', 'abdomen pain', 'back pain']
Polymyalgia rheumatica --> ['fatigue', 'tenderness', 'joint stiffness', 'neck pain', 'shoulder pain', 'pelvic girdle pain']
Post-traumatic stress disorder (PTSD) --> ['unwanted thoughts', 'emotional detachment', 'guilt', 'loss of interest', 'loneliness', 'pleasure in activities', 'irritability', 'social isolation', 'agitation']
Postnatal depression --> ['insomnia', 'repeatedly going over thoughts', 'fatigue', 'loss of appetite', 'anxiety', 'mood swings', 'anger', 'guilt', 'loss of interest']
Postpartum hemorrhage --> ['vaginal bleeding', 'fast heart rate', 'low blood pressure']
Postural orthostatic tachycardia syndrome --> ['fast heart rate', 'nausea', 'anxiety', 'blurred vision', 'fatigue', 'dizziness', 'light headedness', 'fainting', 'inability to exercise']
Pre-eclampsia --> ['headache', 'nausea', 'weight gain', 'blurred vision', 'swelling in extremities', 'fatigue', 'high blood pressure']
Precocious puberty --> ['breast enlargement in men', 'pubic hair', 'acne', 'body odour', 'deepening of voice', 'early onset of menstruation', 'facial hair', 'mammary gland', 'mood swings']
Prediabetes --> ['weight gain', 'frequent urination', 'fatigue', 'excessive hunger', 'excessive thirst']
Premenstrual dysphoric disorder --> ['headache', 'depression', 'fatigue', 'weight gain', 'lack of concentration', 'water retention', 'appetite changes', 'bloating', 'diminished interest in usual activities']
Preterm birth --> ['disproportionately large head compared to body size', 'infant respiratory distress syndrome', 'low body temperature in newborn', 'retinal damage in newborn']
Priapism --> ['prolonged erection', 'urinary retention', 'penis pain']
Prolactinoma --> ['headache', 'vision disorder', 'breast enlargement in men', 'inappropriate breast milk production', 'irregular menstruation', 'absence of menstruation', 'infrequent menstruation']
Prostate cancer --> ['bones pain']
Psoriasis --> ['itching', 'depression', 'joint stiffness', 'inflamed tendons', 'small dents in nails', 'plaque', 'redness', 'rashes', 'peeling']
Psoriatic arthritis --> ['itching', 'fatigue', 'physical deformity', 'skin rash', 'small dents in nails', 'inflamed fingers', 'toes', 'tendonitis', 'back pain']
Psychosis --> ['memory loss', 'nightmares', 'tactile hallucination', 'anxiety', 'general discontent', 'anger', 'apathy', 'loneliness', 'nervousness']
Pulmonary edema --> ['fast heart rate', 'coughing', 'water retention', 'fatigue', 'sweating', 'chest pain', 'fast breathing', 'wheezing', 'rapid breathing']
Pulmonary embolism --> ['dry cough', 'light headedness', 'low oxygen in the body', 'shortness of breath', 'fast breathing', 'palpitations', 'fast heart rate']
Pulmonary hypertension --> ['swelling', 'shortness of breath', 'fast heart rate', 'chest pressure', 'chronic cough', 'swollen legs', 'fatigue', 'dizziness', 'inability to exercise']
Pyloric stenosis --> ['weight loss', 'failure to thrive', 'insufficient urine production', 'baby colic', 'lump in the abdomen', 'severe vomiting', 'dehydration', 'water electrolyte imbalance', 'lethargy']
Raynaud's --> ['toes', 'sensitivity to cold', 'lack of blood supply', 'pallor', 'red fingers', 'reduced sensation of touch', 'throbbing pain in fingers']
Rectal prolapse --> ['mass protruding through the anus', 'constipation', 'leaking of stool']
Repetitive strain injury --> ['tenderness', 'joint stiffness', 'sensation of pins and needles', 'muscle weakness', 'cramping']
Respiratory distress syndrome --> ['coughing', 'muscle weakness', 'organ dysfunction', 'blue skin from poor circulation', 'high carbon dioxide levels in blood', 'fever', 'low oxygen in the body', 'shortness of breath', 'fast breathing']
Restless legs syndrome --> ['charley horse', 'uncomfortable tingling and burning', 'urge to move', 'fatigue', 'restlessness', 'leg pain']
Retinal detachment --> ['blurred vision', 'vision loss', 'sensitivity to light', 'inability to see in dim light', 'seeing spots', 'partial loss of vision', 'temporary loss of vision in one eye', 'seeing flashes of light', 'tunnel vision']
Rhabdomyolysis --> ['kidney damage', 'muscle stiffness', 'fatigue', 'inability to exercise', 'water electrolyte imbalance', 'body ache', 'muscles pain', 'muscle weakness', 'cramping']
Rheumatoid arthritis --> ['physical deformity', 'sensation of pins and needles', 'flare', 'dry mouth', 'fatigue', 'malaise', 'anaemia', 'redness', 'lumps']
Ringworm --> ['hair loss', 'itchy scalp', 'peeling', 'darkening of the skin', 'fissures', 'red rashes', 'scaly patches']
Rosacea --> ['itching', 'photosensitivity', 'large and bulbous red nose', 'red face', 'dryness', 'swollen blood vessels in the skin', 'oily skin', 'rashes that look like acne', 'puffy eyes']
Roseola --> ['swollen lymph nodes', 'irritability', 'sore throat', 'skin rash', 'runny nose', 'red spots on the soft palate', 'fever', 'loss of appetite']
Rotator cuff tear --> ['tenderness', 'joint stiffness', 'shoulder pain', 'muscle weakness', 'loss of muscle']
Rotator cuff tendinitis --> ['tenderness', 'shoulder stiffness', 'shoulder pain']
Salmonella --> ['headache', 'fatigue', 'fever', 'loss of appetite', 'chills', 'dehydration', 'diarrhoea', 'blood in stool', 'abdomen pain']
Sarcoidosis --> ['weight loss', 'swollen lymph nodes', 'coughing', 'fatigue', 'malaise', 'night sweats', 'rashes', 'red and tender lumps', 'eyes pain']
Scabies --> ['itching', 'skin burrow', 'redness', 'bumps']
Schizoaffective disorder --> ['rapid and frenzied speaking', 'appetite changes', 'anxiety', 'mood swings', 'loss of interest', 'hopelessness', 'pleasure in activities', 'euphoria', 'limited range of emotions']
Schizophrenia --> ['fatigue', 'memory loss', 'impaired motor coordination', 'lack of emotional response', 'anxiety', 'general discontent', 'anger', 'loss of interest', 'apathy']
Sciatica --> ['weakness', 'burning sensation', 'foot numbness', 'back pain', 'hip pain', 'buttocks pain', 'lower extremities pain', 'muscle weakness', 'difficulty walking']
Scleroderma --> ['headache', 'weight loss', 'shortness of breath', 'fatigue', 'difficulty swallowing', 'joint stiffness', 'sensitivity to cold', 'chronic cough', 'dry mouth']
Scoliosis --> ['physical deformity', 'muscle spasms', 'leaning to one side', 'uneven waist', 'back pain']
Seasonal affective disorder --> ['depression', 'weight gain', 'lack of concentration', 'fatigue', 'appetite changes', 'anxiety', 'mood swings', 'general discontent', 'loss of interest']
Seborrheic dermatitis --> ['itching', 'dandruff', 'redness', 'rashes', 'peeling', 'dryness', 'flakiness']
Separation anxiety --> ['palpitations', 'nightmares', 'crying', 'rapid breathing', 'anxiety', 'apprehension', 'depression', 'fear']
Sepsis --> ['fast heart rate', 'sleepiness', 'insufficient urine production', 'organ dysfunction', 'delirium', 'skin discolouration', 'fatigue', 'fever', 'dizziness']
Septic shock --> ['fast heart rate', 'mental confusion', 'insufficient urine production', 'fatigue', 'fever', 'chills', 'low blood pressure', 'low body temperature', 'shortness of breath']
Shaken baby syndrome --> ['shortness of breath', 'bruising', 'bleeding', 'tremor', 'seizures', 'sleepiness', 'bone fracture', 'vomiting', 'coma']
Shin splints --> ['lower leg pain after exercise', 'leg pain']
Shingles --> ['itching', 'fatigue', 'burning sensation', 'painful red blister rash in linear distribution', 'redness', 'blister', 'ulcers', 'scab', 'skin pain']
Shoulder impingement --> ['tenderness', 'joint stiffness', 'neck pain', 'shoulder pain', 'arm pain', 'muscle weakness', 'limited range of motion']
Sickle cell anemia --> ['shortness of breath', 'pallor', 'yellow skin and eyes', 'inflamed fingers', 'toes', 'abnormal breakdown of red blood cells', 'fatigue', 'malaise', 'dizziness']
Sinusitis (sinus infection) --> ['headache', 'pus', 'throat irritation', 'phlegm', 'mouth breathing', 'sleeping difficulty', 'inflammation of ear', 'sinus pressure', 'fatigue']
Sjögren's syndrome --> ['swollen lymph nodes', 'fatigue', 'joint stiffness', 'stiffness', 'dry skin', 'dry cough', 'vaginal dryness', 'dry eyes', 'joints pain']
Skin cancer (melanoma) --> ['darkening of the skin', 'bigger mole diameter', 'mole color changes', 'skin mole with irregular border']
Skin tags --> ['darkening of the skin', 'small growth of normal skin']
Slapped cheek syndrome --> ['headache', 'itching', 'nausea', 'coughing', 'sore throat', 'runny nose', 'rash on the face', 'fatigue', 'fever']
Sleep apnoea --> ['headache', 'depression', 'fatigue', 'irritability', 'weight gain', 'mood swings', 'dry mouth', 'dry throat', 'breathing through the mouth']
Sleep paralysis --> ['anxiety', 'paralysis', 'hallucination']
Sleepwalking --> ['fatigue', 'inability to recall sleepwalking after awakening', 'excessive daytime sleepiness', 'falling']
Slipped disc --> ['stiff neck', 'hand numbness', 'foot numbness', 'back pain', 'foot pain', 'leg pain', 'arm pain', 'muscle weakness', 'muscle spasms']
Soil-transmitted helminthiasis --> ['loss of appetite', 'slow growth', 'blood in stool', 'mild nausea', 'abdomen pain']
Spider bite --> ['itching', 'swelling', 'redness', 'blister', 'small bump', 'pimples']
Spina bifida --> ['physical deformity', 'nerve injury', 'intellectual disability', 'hunched back', 'paralysis', "paralysis of the body's lower half", 'constipation', 'leaking of stool', 'bowel obstruction']
Spinal cord injury --> ['shortness of breath', 'abnormal and painful sensation', 'leaking of stool', 'sweating', 'feeling faint', 'muscle weakness', 'problems with coordination', 'stiff muscles', 'muscle spasms']
Spondylitis --> ['sleep disorder', 'inflamed tendons', 'back pain', 'neck pain']
Spondylolisthesis --> ['tenderness', 'stiffness', 'hamstring tightness', 'lower back pain', 'legs pain']
Spondylosis --> ['headache', 'sensation of pins and needles', 'stiffness', 'back pain', 'neck pain', 'shoulder pain', 'legs pain', 'muscle weakness', 'muscle spasms']
Sprained ankle --> ['swelling', 'tenderness', 'bruising', 'limping', 'ankle instability', 'ankle pain']
Staph infection --> ['swelling', 'pus', 'abscess', 'fever', 'chills', 'nausea', 'vomiting', 'diarrhoea', 'redness']
Stasis dermatitis --> ['itching', 'swelling', 'redness', 'rashes', 'blister', 'ulcers', 'dryness', 'darkening of the skin', 'scaly rashes']
Stomach cancer --> ['weight loss', 'difficulty swallowing', 'abdominal fullness', 'loss of appetite', 'cancer related fatigue', 'nausea', 'indigestion', 'dark stool from digested blood', 'vomiting blood']
Stomach flu --> ['headache', 'weight loss', 'fast heart rate', 'weakness', 'insufficient urine production', 'fatigue', 'fever', 'loss of appetite', 'light headedness']
Stomach ulcer --> ['abdominal discomfort', 'fatigue', 'loss of appetite', 'feeling full sooner than normal', 'nausea', 'vomiting', 'indigestion', 'heartburn', 'belching']
Strep throat --> ['headache', 'sore throat', 'enlarged neck lymph nodes', 'swollen tonsils', 'tender lymph nodes', 'bad breath', 'tonsillar exudate', 'fever', 'malaise']
Stroke --> ['headache', 'difficulty swallowing', 'mental confusion', 'rapid involuntary eye movement', 'inability to understand', 'fatigue', 'light headedness', 'vertigo', 'problems with coordination']
Stye --> ['lump on the eyelid', 'eyelid pain', 'eyelid tenderness', 'puffy eyes', 'watery eyes', 'eyelid redness']
Subconjunctival hemorrhage --> ['eye redness']
Sunburn --> ['itching', 'swelling', 'blistering', 'redness', 'rashes', 'peeling', 'flakiness', 'red spots', 'warmness']
Supraventricular tachycardia (SVT) --> ['shortness of breath', 'fast heart rate', 'fatigue', 'sweating', 'light headedness', 'fainting', 'chest pain']
Swimmer's ear --> ['itching', 'tenderness', 'hearing loss', 'redness', 'feeling of fullness in the ear', 'ear pain']
Swine flu --> ['headache', 'shortness of breath', 'sore throat', 'fatigue', 'fever', 'chills', 'nausea', 'vomiting', 'diarrhoea']
Syndrome of inappropriate antidiuretic hormone secretion --> ['headache', 'irritability', 'nausea', 'mental confusion', 'tremor', 'fatigue', 'malaise', 'muscle weakness', 'cramping']
Syphilis --> ['weight loss', 'itching', 'swollen lymph nodes', 'fatigue', 'sore throat', 'mouth ulcer', 'rash on the palms and soles', 'rectal lining inflammation', 'rashes']
Taeniasis --> ['weight loss', 'nausea', 'passing worms in stool']
Tardive dyskinesia --> ['involuntary movements', 'lip smacking', 'repetitive movements']
Temporal arteritis --> ['headache', 'weight loss', 'scalp tenderness', 'fatigue', 'fever', 'loss of appetite', 'jaw pain with chewing pain', 'vision loss', 'temporary loss of vision in one eye']
Temporomandibular disorder (TMD) --> ['headache', 'muscle spasms', 'joint locking', 'ear pain', 'face pain', 'jaw pain', 'mouth pain', 'toothache', 'difficulty chewing']
Tennis elbow --> ['swelling', 'tenderness', 'muscles pain', 'elbow pain']
Tension-type headaches --> ['headache', 'sensitivity to light', 'difficulty falling asleep', 'fear of loud sounds', 'muscles pain', 'neck pain', 'face pain']
Testicular torsion --> ['tenderness', 'swelling of scrotum', 'nausea', 'vomiting', 'abdomen pain', 'testicle pain']
Thalassemia --> ['shortness of breath', 'pallor', 'yellow skin and eyes', 'failure to thrive', 'iron overload', 'fatigue', 'anaemia', 'weakness']
Thoracic outlet syndrome --> ['headache', 'swelling', 'muscle weakness', 'cold sensitivity of the fingers', 'neck pain', 'shoulder pain', 'arm pain']
Thyroid cancer --> ['thyroid nodules', 'neck pain']
Thyroid nodules --> ['lump in the neck', 'enlarged thyroid']
Thyroiditis --> ['fast heart rate', 'muscle weakness', 'tremor', 'sensitivity to cold', 'dry skin', 'sexual dysfunction', 'enlarged thyroid', 'irregular menstruation', 'underactive thyroid']
Tonsil stones --> ['sore throat', 'bad breath']
Tonsillitis --> ['sore throat', 'pus', 'mouth breathing', 'snoring', 'enlarged neck lymph nodes', 'swollen tonsils', 'poor appetite', 'tender lymph nodes', 'bad breath']
Torn meniscus --> ['stiffness', 'swollen knee', 'knee pain', 'difficulty walking', 'limited range of motion']
Torticollis --> ['headache', 'physical deformity', 'stiffness', 'muscle spasms', 'back pain', 'muscles pain', 'neck pain']
Tourette syndrome --> ['coughing', 'learning disability', 'eyelid twitching', 'frequent throat clearing', 'repetitive blinking of eyes', 'stuttering', 'involuntary movements', 'difficulty with bodily movements', 'tic']
Toxoplasmosis --> ['headache', 'enlarged neck lymph nodes', 'fatigue', 'fever', 'muscles pain']
Transient ischaemic attack (TIA) --> ['difficulty swallowing', 'mental confusion', 'reduced sensation of touch', 'light headedness', 'vertigo', 'feeling faint', 'muscle weakness', 'problems with coordination', 'difficulty walking']
Traumatic brain injury --> ['depression', 'bruising', 'bleeding', 'ringing in the ears', 'nerve injury', 'bone fracture', 'sensitivity to sound', 'persistent headache', 'a temporary moment of clarity']
Trichomoniasis --> ['abdomen pain', 'vaginal discharge', 'vaginal itching', 'vaginal odour', 'vaginal inflammation', 'vaginal irritation', 'vulval inflammation', 'cervix inflammation']
Trigeminal neuralgia --> ['muscle spasms', 'paroxysmal attack of facial pain', 'severe facial pain', 'sharp facial pain', 'unilateral facial pain', 'mouth and face pain']
Trigger finger --> ['swelling', 'physical deformity', 'tenderness', 'finger catching with sudden pop release', 'stiffness', 'lump']
Trochanteric bursitis --> ['tenderness', 'stiffness', 'hip pain']
Tuberculosis --> ['shortness of breath', 'swollen lymph nodes', 'phlegm', 'severe unintentional weight loss', 'loss of muscle', 'fatigue', 'fever', 'loss of appetite', 'malaise']
Turner syndrome --> ['hearing loss', 'vision disorder', 'scoliosis', 'absence of menstruation', 'underactive thyroid', 'obesity', 'dysplastic nail', 'female infertility', 'recurrent ear infections']
Type 1 diabetes --> ['headache', 'weight loss', 'fast heart rate', 'blurred vision', 'sleepiness', 'frequent infections', 'fatigue', 'sweating', 'excessive thirst']
Type 2 diabetes --> ['blurred vision', 'poor wound healing', 'frequent urination', 'fatigue', 'excessive hunger', 'excessive thirst', 'weight loss', 'weight gain']
Ulcerative colitis --> ['weight loss', 'cramping', 'fatigue', 'fever', 'loss of appetite', 'anaemia', 'bloating', 'diarrhoea', 'blood in stool']
Umbilical hernia --> ['soft swelling', 'bulge near the navel']
Underactive thyroid (hypothyroidism) --> ['irritability', 'weight gain', 'constipation', 'sensitivity to cold', 'brittle nails', 'dry skin', 'sexual dysfunction', 'enlarged thyroid', 'slow heart rate']
Upper respiratory infection --> ['headache', 'swollen lymph nodes', 'coughing', 'phlegm', 'inflammation of ear', 'fatigue', 'fever', 'sinuses pain', 'wheezing']
Uterine cancer --> ['weight loss', 'abnormal vaginal bleeding', 'pelvis pain', 'irregular menstruation', 'abnormal menstruation', 'heavy menstruation']
Uveitis --> ['swelling', 'eye redness', 'leaked fluid out of blood vessels', 'an organ', 'eyes pain', 'blurred vision', 'vision loss', 'sensitivity to light', 'seeing spots']
Vaginal yeast infection --> ['redness', 'vagina pain', 'vaginal discharge', 'vaginal itching', 'vaginal inflammation', 'vulval inflammation']
Vaginitis --> ['vaginal erythema', 'vagina pain', 'abnormal vaginal discharge', 'vaginal itching', 'vaginal odour', 'vaginal bleeding', 'vaginal irritation']
Varicose veins --> ['itching', 'bruising', 'swollen legs', 'heavy legs', 'swollen blood vessels in the skin', 'discolouration']
Vasculitis --> ['weight loss', 'shortness of breath', 'sensation of pins and needles', 'joint swelling', 'fatigue', 'fever', 'rashes', 'ulcers', 'abdomen pain']
Ventricular septal defect --> ['swelling', 'failure to thrive', 'blue skin from poor circulation', 'baby feeding difficulties', 'fatigue', 'sweating', 'inability to exercise', 'shortness of breath', 'fast breathing']
Vitamin B12 deficiency --> ['shortness of breath', 'pallor', 'memory loss', 'tingling feet', 'reduced sensation of touch', 'fatigue', 'anaemia', 'poor balance']
Vitiligo --> ['loss of skin colour', 'premature hair whitening']
Von Willebrand disease --> ['easy bruising', 'excessive bleeding during childbirth', 'heavy', 'prolonged periods', 'mouth bleeding', 'nosebleed', 'tendency to bleed easily']
Warts and verrucas --> ['itching', 'lesions in mouth', 'around genital regions', 'thickness', 'small growths on skin']
Whiplash --> ['headache', 'tenderness', 'sensation of pins and needles', 'muscle spasms', 'sleep disorder', 'stiff neck', 'nerve injury', 'difficulty focusing', 'dizziness']
Whooping cough --> ['vomiting', 'watery eyes', 'paroxysmal cough', 'episodes of no breathing', 'fatigue', 'fever']
